bredtorienteret	K99
varetage opbygning og drift af servicefunktioner	knowledge
indgå i et team	knowledge
alsidig	K99
renovering- og restaureringsopgaver	K99
Reperationsarbejder	K99
Flisearbejder	K99
Tagarbejder	K99
imuring af rygninge og grater	knowledge
fagudlært murer	knowledge
brænde for dit fag	knowledge
arbejde selvstændigt	K99
kundemindet	K99
arbejde sammen på tværs af faggrænser	K99
kørekort b og gerne be	knowledge
ledelseserfaring	K99
kvik	S4
arbejde selvstændigt	K99
kan lide at have travlt	knowledge
min tid	L1
arbejde med komplicerede patientforløb	K99
omsorg	K99
kol-team	K07
diabetes mellitus	K09
kol	K99
niv ( non invasiv ventilation	K07
lomholt-system	K07
clinical suite	K02
engageret	K99
korrespondance	K99
post	K04
arkivering	K99
bogføring	K99
regnskabsmæssige opgaver	K99
personalerelaterede opgaver	K99
administrativt sagsarbejde	K99
indkøb af kontorartikler	K99
vedligeholdelse af intranet og hjemmeside	knowledge
kontoruddannet	K99
it	K07
bogføring	K99
arbejdet i en kommune	knowledge
åben	K99
udadvendt	K99
bevare overblikket og begge ben på jorden	knowledge
velformuleret	K99
omstillingsparat	K99
fleksibel	K99
godt humør	knowledge
opus	K99
skrivning af notater i opus fra mirsk	knowledge
MIRSK	K99
opus	K99
ris	S1
LABKA	K99
indkaldelse af patienter	knowledge
finde journaler frem til ugeprogram	S6
oplæring af elever	K99
Officepakken	K99
GSÅben	K99
opus notat	knowledge
epikrise	K99
MIRSK	K99
orbit	K07
Labka	K99
ris	S1
godt humør	knowledge
kan lide at have travlt	knowledge
robust	K07
arbejde i et team	knowledge
en 473/	L1
endoskopi	K99
Olympus Iplex	K99
selvstændigt	K99
rejsevant	K99
bidrage til fremtidig udvikling?	knowledge
dygtigste	K99
effektive	K99
strukturerede	K99
herlig men stærk og udadvendt kommunikerende personlighed	knowledge
godt humør	knowledge
let til smil	knowledge
går altid foran med dit eksempel	knowledge
høj stresstærskel	knowledge
have mangebolde i luften	K99
initiativrig	K99
løsningsorienteret	K99
effektiv	K99
bevare overblikket	K99
struktureret	K99
trives i travl omskiftelig hverdag	knowledge
lagererfaring	K99
rengøringsartikler	K99
ledererfaring	K99
klar til en stor udfordring	knowledge
jernvilje	K99
personligt drive	S4
få styr på lageret	knowledge
deltager aktivt i den daglige drift	knowledge
varemodtagelse	K99
pluk og pak	K07
forsendelse	K99
rengøring i butik ,slagter og bager	knowledge
stabil	K99
grundig	K99
Kvalitetsbevist	K99
Serviceminded	S1
arbejde selvstændig og i team	S4
dansk	K04
øge kvaliteten	knowledge
sænke omkostningsniveauet	K99
ledererfaring	K99
økonomi	K99
it og statistik	K03
løn- og personaleadministration	S1
realisere visionen	K99
sikre en stærk ledelse af myndighedsopgaverne	knowledge
varetage dialogen	knowledge
løn og personale	S1
regnskab	K99
ledelsesinformation	K99
it	K07
strategisk sans	knowledge
ledererfaring	K99
akademisk uddannelse	K04
lederuddannelse	K99
forretningsforståelse	K99
levere stærke strategiske bud	knowledge
udadvendte facon	K99
personlige pondus	S1
skabe gode relationer til samarbejdspartnere	K99
fastholde en naturlig gennemslagskraft	K99
skabe et inspirerende arbejdsmiljø	S1
motivere dine medarbejdere	S3
levere synlige resultater	knowledge
dygtig	K99
engageret	K99
frisk	K99
engageret	K99
udadvendt	K99
godt humør	knowledge
klar til at lære nyt	knowledge
arbejde med computer	K99
servicere vores web-butik	S6
service og kvalitets orienteret?	K04
serviceminded	S1
selvstændig	K99
ansvarsbevidst	K99
Diners	K10
Eurocard	K99
Fakturere	K99
fakturere samt følge op på debitorer	knowledge
bogføre indbetalinger	K99
have overblik over de forskellige konti for caféerne	knowledge
videreudvikling at rutiner og systemer	knowledge
regnskab	K99
administration	K09
giver venlig service overfor vores leverandrøre medarbejdere	S3
bevarer overblikket i hverdagen	knowledge
arbejde selvstændigt	K99
god til at samarbejde	K08
office-pakken	K07
har lyst til forandring udvikling	knowledge
bevare overblikket i stressede situationer	knowledge
forene basal sygepleje og højteknologi	knowledge
arbejde bevidst med faglige og personlige kompetencer	S1
handlekraftig	K99
påtage dig ansvar	knowledge
være i meget tæt kontakt med patienter og pårørende	S1
turde gøre en forskel	knowledge
blive udfordret på etiske overvejelser	knowledge
bidrage til udvikling af sygeplejen	knowledge
gå i front	K07
gå på akut kald	knowledge
samarbejde på tværs af et stort hospital	knowledge
telefonisk kundeservice og salg	K07
flair for it	S6
høj stress tærskel	knowledge
skarp i en dialog	knowledge
salgsminded	K99
tager ejerskab over dit arbejde	K99
vælger at se udfordringer/problemstillinger fra den mest positive vinkel	knowledge
energisk	K99
villig til at arbejde hårdt og målrettet	knowledge
vinder og konkurrence menneske	knowledge
etik	K99
kundeservice	K99
kvalitetsbevidst	K99
stabil	K99
kold og varm madlavning	knowledge
opfyldning af buffet	K99
køkken	K99
kantine	K99
hygiejnebevis	K99
fleksibel	K99
udadvendt	K99
præsentabel	K99
tager nye udfordringer med et godt humør	knowledge
lede og koordinere de mange forskellige vejledningsopgaver	knowledge
indskrivning	K99
fastholdelsessamtaler	K99
kurser	K99
samarbejde med lærere og administration	K04
telefon- og træffetid	K07
planlægning og evaluering af kursustilbud	knowledge
uddannelsessektoren	knowledge
samarbejds- og organisatoriske evner	K99
bevare overblikket	K99
godt humør	knowledge
varetage den kliniske uddannelse af sygeplejestuderende	knowledge
varetage den kliniske uddannelse af 4-6 sygeplejestuderende pr	knowledge
bedside-undervisning	K01
planlægge og afvikle individuelle kliniske uddannelsesforløb	knowledge
planlægge og gennemføre studiesamtaler	knowledge
vejlede og eksaminere ved interne prøver	knowledge
planlægge og gennemføre opfølgningsmøder	K99
fastholde og videreudvikle et lærings- og studiemiljø hvor refleksion vejledning og undervisning er i fokus	knowledge
informere og ajourføre afsnittet om udviklingen indenfor sygeplejerskeuddannelsen	knowledge
dansk autorisation som sygeplejerske	K03
pædagogisk efteruddannelse svarende til 1/6 diplom	K03
sygeplejerskeuddannelsen	K99
engagement og interesse indenfor det kliniske såvel som pædagogiske felt	knowledge
kliniske såvel som pædagogiske felt	knowledge
debitor- og kreditorstyring	K99
kontering og bogføring af bilag	K07
afstemning af kasse og bankkonti og øvrige mellemregningskonti	knowledge
Momsindberetning	K99
kontrol og frigivelse af lønbilag	knowledge
regnskabsmæssig forståelse	K99
navision stat	K99
statens lønsystem	K99
arbejder med kontaktpersonsfunktion	knowledge
arbejder jeg-støttende	K99
arbejde med mennesker med en psykisk sygdom	knowledge
arbejde i et tæt tværfagligt samarbejde	K99
arbejde selvstændigt	K99
træffe de nødvendige beslutninger	K99
bevist om sin måde at kommunikere på	S6
praksisnærhed	K99
faglighed	K99
videreudvikling	K10
kvalitetssikring	K99
undervise	S1
Erhvervsøkonomi	K99
salg og service	K10
Samfundsfag	K99
it	K07
undervise	S1
administration	K09
økonomi	K99
ha	K99
cand.merc	K04
undervise	S1
tysk	K99
engelsk	L1
dansk	K04
Samfundsfag	K99
ba	K99
uddannelses på kandidatniveau	K99
dygtig	K99
engageret	K99
har lyst til at undervise	S5
teamorienteret	K99
indstillet på tværfagligt samarbejde	K99
humor	S3
humanistisk livssyn	knowledge
udadvendt	K99
skabe relationer	K99
ser forandringer og udviklingsmuligheder som en udfordring	knowledge
helhedsorienteret	K99
pædagogikum	K99
værtskab	K99
service	S3
kontakt til vore mange gæster	knowledge
gøre en positiv forskel	knowledge
professionel servering	K07
a la carte	K99
selskab	K99
vejlede gæster i valg af menu og vine	knowledge
skabe resultater som kan ses og mærkes	knowledge
fagligt stolt	K99
sætter en ære i at vore gæster får de bedste personlige oplevelser	knowledge
sælgende	K99
kontaktskabende	K99
velsoigneret	K99
smilende	K99
god fysik	K99
bevare overblikket i stressede situationer	knowledge
samarbejde på tværs af afdelinger og faggrupper	K99
ser en fordel i at have et varieret arbejdsskema med skiftende arbejdstider	knowledge
anerkendende	K99
imødekommende	K99
indgå i et tværfagligt team	knowledge
direkte plejerelateret opgaver	K99
opvarmning og anretning af aftensmad	knowledge
arbejde med ældre borgere på midlertidigt ophold	K99
arbejde ud fra en helhedsorienteret vinkel	knowledge
samarbejder ud fra et anerkendende fokus	K99
bevare roen og overblikket	S6
smilende	K99
fleksible	K06
hjælpsomme	K99
smager på maden	knowledge
dyrke madglæden og de gode råvarer	knowledge
mellemstort køkken	K07
Helsingør	K99
positiv af sind	knowledge
hjælpsom	K99
finder løsninger selvom du er presset	knowledge
fleksibel	K99
ser mulighederne i et frit samarbejde	knowledge
bespise alle slags mennesker	knowledge
opfordrer børnene til at være hjælpsomme hensynsfulde og positive	knowledge
styrke gruppefællesskabet	K99
giver børnene mulighed for medbestemmelse	K99
alsidig	K99
aktiv	K99
positiv	K99
samarbejdsorienteret	K99
godt overblik	K99
skabe en tryg og udviklende dagligdag for børnene	knowledge
brænder for sit fag	knowledge
musik	K99
natur	K99
udeliv	K99
orientere sig	K99
arbejde med it som værktøj	K99
fagligt velfunderet	K99
reflektere over din praksis	knowledge
opstilling af regnskaber/årsregnskaber	K99
revision	K07
moms	K99
daglig kontering	K99
kommunikation og it	S5
informatik	K99
programmering	K06
medialogi	K99
tages højde for elevens selvstændighed og personlige udvikling	knowledge
undervisning og planlægning i et tæt teamsamarbejde	knowledge
cand.scient i informatik	K03
cand.mag i multimedier humanistisk informatik	K03
computerspilsbranchen	K99
PG/pædagogikum	K99
interaktive medier	K02
programmering	K06
gamification	K99
computerspilsudvikling	K99
skabe tillid og kontakt til unge mennesker	knowledge
naturlig autoritet	K99
let ved at sætte rammer for det faglige samvær med eleverne	knowledge
samarbejde med kollegerne	K99
kreativ	K99
innovativ	K99
respekt for menneskers forskelligheder	knowledge
påvirke andre på en positiv måde	knowledge
grafiske evner	K99
kvalitetssikring af grafisk materiale	knowledge
sammensætning af 360-billeder	knowledge
efterbehandling af corporate billeder	knowledge
billedredigering	K99
InDesign	K99
photoshop	K06
detaljeorienteret	K99
effektiv	K99
arbejder selvstændigt	K99
arbejdsmoral	K99
billedbehandling	K99
fagligt dygtig	K99
engageret	K99
arbejdsmarkedspolitik	K99
statistik	K99
samfundsøkonomi	K99
stud.polit	K03
stud.scient.oecon	K03
stud.ha	K99
stærk faglig profil	knowledge
fordyber dig i og tager ansvar for de opgaver du stilles overfor	knowledge
analytiske og metodiske færdigheder	knowledge
skriftlige formidlingsevner	knowledge
kvantitative analyser	S2
arbejde dybdegående med empiriske og statistiske analyser	K03
skabe grundlag for fremtidens politikudvikling	knowledge
kvantitative og statistiske evalueringer	K03
analyser med brug af individdata	knowledge
sas	K06
statistiske værktøjer	K99
behandling af store mængder data	knowledge
gåpåmod	K99
arbejde med empirisk metode	knowledge
koble resultaterne til den økonomiske teori	knowledge
”ole opfinder”	S6
svejse	K99
arbejde selvstændigt	K99
flair for teknik	S2
”regne den ud”	S6
udvikle / designe / samle / svejse en kabine	knowledge
pp tråds hånd svejser	knowledge
indgå i et samarbejde	K99
trykning af ekstrakter	K99
kopiere ankesagens dokumenter	knowledge
vedligeholdelse af tjenestekøretøjer	K99
opsætning af udstyr	K99
papir- og affaldshåndtering	K99
sikre kvalitet og effektivitet i vores sagsbehandling	knowledge
gode evner for samarbejde	K99
serviceminded	S1
robust	K07
engageret	K99
stabil	K99
ansvarsbevidst	K99
pligtopfyldende	K99
udfører dine opgaver med høj kvalitet	knowledge
situationsfornemmelse	K99
fleksibel	K99
overkomme fysiske arbejdsopgaver	K99
godt humør	knowledge
kørekort til personbil b	knowledge
afholde status	K05
plukkes	K99
pakkes	K99
fysik i orden	knowledge
fysisk arbejde	K99
går engageret til dine arbejdsopgaver	K99
stabil	K99
pligtopfyldende	K99
går op i detaljen	knowledge
effektiv	K99
engelsk	L1
ordenssans	K99
grundig i dine arbejdsopgaver	K99
god fysik	K99
fysisk arbejde	K99
sætter borgeren i centrum	knowledge
lære nyt	S5
humoristisk sans	K99
samarbejde	K99
lungemedicin	K99
varetage specialiserede og almene lungemedicinske opgaver	knowledge
videreudvikle området	knowledge
bidrage på visionærvis og aktivt til at udvikle specialet yderligere	knowledge
indgå engageret i både videreudvikling og drift af det lungemedicinske speciale	knowledge
understøtte en kultur hvor der lægges vægt på et godt og dynamisk arbejdsmiljø	knowledge
kommunikative egenskaber	K99
samarbejde tværfagligt	K99
bidrage aktivt til forskning uddannelse og kvalitetsudvikling	S4
gå aktivt ind i afdelingens kvalitetsarbejde	knowledge
optimering af patientforløb og patient- og pårørendeinvolvering	K99
jordemoderfaget	K99
konsultationsarbejde	K99
barselsklinik	K03
ammeklinik	K99
fleksibel	K99
hjælpe med at passe svangre- og barselspatienter	knowledge
hjælper hinanden på tværs af afsnittene	knowledge
klinisk sparring	S3
vejlede studerende	K08
deltage i projektarbejde	K99
stan certificeret	knowledge
jordemoderfaglig visionær	K99
pædagogiske empatiske og kommunikative evner	K03
Glad	S4
imødekommende	K99
initiativrig	K99
fleksibel	K99
omstillingparat	K99
arbejde med at udvikle samt forbedre klinisk praksis	knowledge
forsknings- og udviklingsarbejde	S4
patientsikkerhed	K99
patientinvolvering	K99
rationel drift	K07
rengøring	K99
tøjvask	K99
udviklingsorienteret	K99
planlægge en inklusionsårsplan	knowledge
være en del af skolens ressourcecenter/pædagogisk læringscenter	knowledge
samarbejde med lærere elever forældre ledelsen samt øvrige eksterne samarbejdspersoner	L1
godt funderet skriftligt og mundtligt	knowledge
inklusionsfremmende aktiviteter	knowledge
arbejde selvstændigt og tværfagligt	K99
sætte din viden i spil i forhold til kolleger med forskellige faglige baggrunde	knowledge
mangfoldighed	K99
fællesskaber	K99
inkluderende læringsmiljøer?	S1
inkluderende læringsmiljøer	K99
omsorg	K99
kontakt	K99
udvikling af børnenes muligheder for at deltage i læringsfællesskaber ( leg klasse- og læringsrummene frikvarter	knowledge
være en del af skolens ressourcecenter/pædagogisk læringscenter	knowledge
udvikler en observations- og sparringskultur	knowledge
støtte lærerne forældrene og eleverne i et struktureret og forudsigeligt læringsmiljø	knowledge
sparring med lærerne	S1
stimulering og udvikling af fællesskab sociale og personlige kompetencer hos eleverne	knowledge
understøtte enkelte eller grupper af elever	knowledge
social træning	K10
samarbejde tæt med en række af skolens lærere	knowledge
arbejde med retningslinjer for datamodellering	K99
datamodellering	K99
gøre en forskel	knowledge
udnytte værdien af store datamængder optimalt?	S1
tænker strategisk	K99
arbejde med model- og datastandarder	knowledge
arbejde i tæt samspil med it-arkitekter og udviklere	knowledge
designe og optimere løsninger på vores nye dataplatform	knowledge
designe og implementere værdiskabende datamodeller	S1
udforske analytiske muligheder	K99
rådgive og støtte organisationen i strategisk anvendelse af data	knowledge
implementere og vedligeholde governance	K10
definere metoder og processer for udvikling og drift	knowledge
udvikle og implementere strategi og roadmap	K08
designe og kommunikere standarder for datamodellering og metadataregistrering	K08
støtte og køre vores data governance-program	knowledge
igangsætte nødvendige initiativer i projekterne	knowledge
engagere dig i datakvalitetskontrolprocesser	knowledge
dokumentere og vedligeholde fysisk og logisk dataarkitektur	K03
understøtte daglige issues vedrørende datadokumentation	knowledge
etablere og vedligeholde reference- og løsningsarkitektur	knowledge
målbilleder	K99
guidelines	S3
principper	K99
udnytte data på nye måder	knowledge
arbejde dedikeret	K99
sikre effektiv udvikling af værdiskabende løsninger	knowledge
information/data	K06
processer	S6
dataintegrationer	K99
implementering af nye it-løsninger	knowledge
arbejde på et højt abstraktionsniveau	K99
designe og/eller omsætte tekniske beskrivelser og behov til tekniske og datamæssige løsninger	knowledge
samarbejde	K99
sikre den nødvendige koordinering og videndeling	knowledge
formidler	K99
holder hovedet koldt i pressede situationer	knowledge
arkitektur	K99
data	K06
ny teknologi	K99
mod på at lære nyt	knowledge
arbejde projektorienteret	K99
Datamodelleringskoncepter	K99
data vault	K06
Snowflake	K99
3	K06
datamodeller på bl.a	K06
xml	K06
CSV	K99
AVRO	K99
PARQUET	K99
Arkitekturrammeværk	K99
zachman framework	K06
Datamodelleringsværktøjer	K99
ea sparks	K07
Qualiware	K99
Datakvalitetskoncepter	K99
cloud-baseret it-arkitektur eller udvikling	knowledge
etl	knowledge
data lake	K06
metadata registrering og lineage	knowledge
design af løsninger i en offentlig kontekst	knowledge
fda	K99
OIO	K99
opbygning af data flows	S5
sikre beboerne en høj livskvalitet	knowledge
omstille dig til nye rutiner	knowledge
deltage i dækningen af vagter ved sygdom	knowledge
arbejde med plejen af ældre	K99
arbejde med at dokumentere	K99
KOS2	K99
betjene psykiatrisk center	K03
tjeneste	K99
udadvendt	K99
energi- og kraftværksområdet	K99
projektledelse af teknisk komplicerede og udfordrende energianlæg	knowledge
-biomassekonvertering af fossilfyrede kraftværker	K99
-optimering af kraftværker og anlæg	knowledge
-projektering af nye kraftværksanlæg	K99
-drift- og vedligeholdelse af anlæg	knowledge
task force indsats	S4
haverier	K99
due diligence projekter	S1
feasibility studier	K05
strategi indsatser	K99
arbejde tæt sammen med kunder	K99
opbygge gode relationer til netværk	knowledge
arbejde i et dynamisk miljø	knowledge
interesse for at udvikle dig	knowledge
energi	K99
kraftværker	K99
miljø	S8
energiområdet	K99
projektledelse	K99
energiområdet	K99
byggeri og anlæg	knowledge
strukturere projektets faser	knowledge
sikre effektiv projektafvikling	K10
projektering/projektledelse	K07
komplette projektforløb	K99
planlægning	K99
projektering af anlæg	knowledge
udbud samt tilsyn	K99
projekt- og byggeledelse	K99
kraftværker	K99
miljøanlæg	K10
kontekst- og forretningsforståelse	K99
arbejde systematisk	K99
arbejde i et internationalt miljø	knowledge
dansk	K04
engelsk	L1
frisk sælgende personlighed?	S1
kontakte virksomhedsledere og andre ansættende ledere i mindre og mellemstore virksomheder	knowledge
arbejder selvstændigt	K99
højt aktivitetsniveau	K99
salgsdialoger	K99
skaffe nye kunder i butikken	knowledge
god energi	K99
indstilling til at ville lykkes	S5
vindermentalitet	K99
motiveres af et ja tak	knowledge
ikke lader dig slå ud af et nej tak	knowledge
social	S1
skaber en god stemning	knowledge
New Bizz	K99
bagerfaget	K99
kvalificeret	K99
energisk	K99
reservedels indkøb håndtering udlevering og salg	knowledge
værkstedsplanlægning	K99
indskrivning	K99
skadekoordinering med eksternt pladeværksted	K99
telefonekspedition	K99
Engageret	K99
selvstændig	K99
ansvarlig	knowledge
serviceminded	S1
Dracar+	K99
Suzuki	K99
sælge produkter	S1
tillid	K99
loyalitet	K99
smil	K99
positiv energi	K99
samarbejde	K99
koordinering	K99
positiv indstilling til samarbejde problemløsning og tilgang til andre mennesker	S4
pet/ct	K07
spect	K99
fysiologi	K99
kombinere fysiologi med anatomi	K03
anatomi	K99
diagnostik	K99
stadieinddeling af sygdomme	K99
terapimonitorering	K99
matematiske begavelse	K99
visuelle betragtende hjerne	knowledge
behandling med radioaktive lægemidler	knowledge
visitation	K99
beskrivelser af forskellige typer undersøgelser	knowledge
fysiologisk og/eller medikamentel belastning af hjertet	knowledge
hjerteperfusionsundersøgelser	K99
klinisk fysiologi	K03
nuklearmedicin	K99
abcde principperne	K99
måle værdier	K99
måle crp hæmoglobin og leucocyter	K08
stixe urin	K99
tage dyrkninger	K99
sonde	K99
urin-kateter	K99
pvk	K99
CVK	K99
sc-nål	K99
hjerte lunge speciale	K10
forebygge indlæggelser	knowledge
sikre tæt samarbejde med relevante samarbejdspartnere	knowledge
skabe høj kvalitet i borgerens behandlingsforløb	knowledge
understøtte en ensartet og høj kvalitet på tværs af sektorer	knowledge
sektorovergange	K99
relationskompetencer	K99
faglig nysgerrighed	K99
varetagelse af sygeplejeopgaver	K99
håndtering af ustabile borgere	knowledge
arbejde løsningsorienteret	K99
arbejde selvstændigt	K99
tage beslutninger i pressede situationer	knowledge
fejlfinding på og reparation af produktionsmaskiner	K99
forebyggende vedligehold	K99
planlægning af større eftersyn	knowledge
tilsyn og planlægning af arbejdsopgaver for eksterne håndværkere	knowledge
optimering af produktionsudstyr	K99
projektarbejde	K99
teknisk profil	K06
el arbejde	K99
procesteknisk forståelse	K03
større rørinstallationer	knowledge
regulering af tryk og flow	K07
el-styringer	K99
industrigasser	K99
prioritere	K99
planlægge	K99
overblik	K99
arbejder struktureret og pligtopfyldende	K99
kommunikations- og samarbejdsevner	K99
positiv	K99
engageret	K99
arbejder selvstændigt og kvalitetsbevist	K99
fokus på overholdelse af deadlines	knowledge
bidrager til et højt sikkerhedsniveau	knowledge
godt humør	knowledge
søge og dele viden	knowledge
engelsk	L1
it	K07
inspirere	K99
udfordre	K99
rumme	K99
aktiv medspiller	K99
anerkende tilgang	K99
respekterer og gerne udfordrer kollegers idéer og pædagogiske arbejde	knowledge
ledelse	K99
personaleledelse	K99
samarbejde	K99
drive og videreudvikle et rigtig godt børnehus	knowledge
trivsel	K99
lede en integreret institution	knowledge
faglighed	K99
lytte	K99
reflektere	K99
omsætte visioner til handling	S6
lydhør	K99
inddrager kolleger	K99
træffe beslutninger	K99
gå forrest	knowledge
overblik	K99
rummer samtidig nærvær og de små detaljer	knowledge
arbejde videre med mange af de tiltag vi allerede har i gang	knowledge
inspirerer også til kommende tiltag	knowledge
synlig i huset	knowledge
trives med de forskellige aspekter jobbet byder på	knowledge
ledelsesopgaver	K99
dialogbaseret	K99
anerkendende	K99
videreformidle	K99
inspirere	K99
kommunikerer ligeværdigt imødekommende og med tydelighed	K99
it-systemer	K99
humor	S3
humør	K99
skabe det gode børneliv	K99
indgå i et mindre sjak	knowledge
vejen som arbejdsplads	knowledge
kloak	K99
fiber	K07
fjernvarme	K99
Håndmandsarbejde	K99
vejen som arbejdspalds	K99
fjernvarme	K99
kloak	K99
fiber	K07
dansk	K04
troværdigt og inspirerende sætte retning	knowledge
stå i spidsen	L1
skabe engagement og følgeskab	knowledge
skabe en stabil og autentisk forbindelse	knowledge
sætte dagsordenen	K99
være værdiskabende	K99
levere skarpt fagligt og strategisk med- og modspil	knowledge
matche kravene til ledelse af den faglige indsats forhandlinger håndtering af vanskelige sager	knowledge
lang videregående uddannelse	knowledge
juridisk kompetence	K99
robust	K07
gennemslagskraft	K99
direkte ledelse	knowledge
ledelse af ledere	knowledge
ledelse	K99
personalejura	K99
arbejdsmiljø	K99
kompetence- og organisationsudvikling	K08
tillidsfuldt og konstruktivt samarbejde	K99
integritet	K99
ordentlighed	K99
loyalitet	K99
sikre såvel kompetent ledelse udvikling og styring af egen afdeling som den tværgående strategiske udvikling af hele organisationen	knowledge
hr-området	K99
telefonkontakt internt og eksternt	K03
administration for caféerne	K10
behandle og bogføre diners eurocard og pbs	knowledge
kronisk medicinsk speciale	K09
