bredtorienteret	K99
varetage opbygning og drift af servicefunktioner	K10
indgå i et team	K10
alsidig	K99
renovering- og restaureringsopgaver	K99
Reperationsarbejder	K99
Flisearbejder	K99
Tagarbejder	K99
imuring af rygninge og grater	knowledge
fagudlært murer	knowledge
brænde for dit fag	knowledge
arbejde selvstændigt	K99
kundemindet	K99
arbejde sammen på tværs af faggrænser	K99
kørekort b og gerne be	knowledge
ledelseserfaring	K99
kvik	K99
arbejde selvstændigt	K99
kan lide at have travlt	K99
min tid	K99
arbejde med komplicerede patientforløb	K99
omsorg	K99
kol-team	K07
diabetes mellitus	K09
kol	K99
niv ( non invasiv ventilation	K07
lomholt-system	K05
clinical suite	K09
engageret	K99
korrespondance	K99
post	K07
arkivering	K99
bogføring	K99
regnskabsmæssige opgaver	K99
personalerelaterede opgaver	K99
administrativt sagsarbejde	K99
indkøb af kontorartikler	K99
vedligeholdelse af intranet og hjemmeside	K10
kontoruddannet	K99
it	K07
bogføring	K99
arbejdet i en kommune	K99
åben	K99
udadvendt	K99
bevare overblikket og begge ben på jorden	knowledge
velformuleret	K99
omstillingsparat	K99
fleksibel	K99
godt humør	knowledge
opus	knowledge
skrivning af notater i opus fra mirsk	K10
MIRSK	K99
opus	knowledge
ris	S1
LABKA	K99
indkaldelse af patienter	K10
finde journaler frem til ugeprogram	knowledge
oplæring af elever	K10
Officepakken	K99
GSÅben	K99
opus notat	knowledge
epikrise	K99
MIRSK	K99
orbit	K07
Labka	K99
ris	S1
godt humør	knowledge
kan lide at have travlt	K99
robust	K07
arbejde i et team	K10
en 473/	K99
endoskopi	K99
Olympus Iplex	K06
selvstændigt	K99
rejsevant	K99
bidrage til fremtidig udvikling?	K10
dygtigste	K99
effektive	K99
strukturerede	K99
herlig men stærk og udadvendt kommunikerende personlighed	K10
godt humør	knowledge
let til smil	S2
går altid foran med dit eksempel	S3
høj stresstærskel	K10
have mangebolde i luften	K99
initiativrig	K99
løsningsorienteret	K99
effektiv	K99
bevare overblikket	K99
struktureret	K99
trives i travl omskiftelig hverdag	K99
lagererfaring	K99
rengøringsartikler	K99
ledererfaring	K99
klar til en stor udfordring	knowledge
jernvilje	K99
personligt drive	S8
få styr på lageret	knowledge
deltager aktivt i den daglige drift	K10
varemodtagelse	K99
pluk og pak	K07
forsendelse	K99
rengøring i butik ,slagter og bager	K99
stabil	K99
grundig	K99
Kvalitetsbevist	K99
Serviceminded	S1
arbejde selvstændig og i team	K10
dansk	K99
øge kvaliteten	knowledge
sænke omkostningsniveauet	K10
ledererfaring	K99
økonomi	K99
it og statistik	K03
løn- og personaleadministration	S4
realisere visionen	S3
sikre en stærk ledelse af myndighedsopgaverne	K10
varetage dialogen	K99
løn og personale	S1
regnskab	K99
ledelsesinformation	K99
it	K07
strategisk sans	K06
ledererfaring	K99
akademisk uddannelse	K02
lederuddannelse	K99
forretningsforståelse	K99
levere stærke strategiske bud	knowledge
udadvendte facon	K99
personlige pondus	S5
skabe gode relationer til samarbejdspartnere	S3
fastholde en naturlig gennemslagskraft	K99
skabe et inspirerende arbejdsmiljø	K10
motivere dine medarbejdere	S3
levere synlige resultater	S4
dygtig	K99
engageret	K99
frisk	K99
engageret	K99
udadvendt	K99
godt humør	knowledge
klar til at lære nyt	knowledge
arbejde med computer	S5
servicere vores web-butik	L1
service og kvalitets orienteret?	K10
serviceminded	S1
selvstændig	K99
ansvarsbevidst	K99
Diners	K10
Eurocard	K99
Fakturere	K99
fakturere samt følge op på debitorer	S8
bogføre indbetalinger	K99
have overblik over de forskellige konti for caféerne	S8
videreudvikling at rutiner og systemer	K10
regnskab	K99
administration	K09
giver venlig service overfor vores leverandrøre medarbejdere	S3
bevarer overblikket i hverdagen	K99
arbejde selvstændigt	K99
god til at samarbejde	S3
office-pakken	K02
har lyst til forandring udvikling	K10
bevare overblikket i stressede situationer	K10
forene basal sygepleje og højteknologi	K10
arbejde bevidst med faglige og personlige kompetencer	S3
handlekraftig	K99
påtage dig ansvar	knowledge
være i meget tæt kontakt med patienter og pårørende	S3
turde gøre en forskel	knowledge
blive udfordret på etiske overvejelser	K10
bidrage til udvikling af sygeplejen	K10
gå i front	K99
gå på akut kald	knowledge
samarbejde på tværs af et stort hospital	K10
telefonisk kundeservice og salg	S2
flair for it	S2
høj stress tærskel	K10
skarp i en dialog	knowledge
salgsminded	K99
tager ejerskab over dit arbejde	K99
vælger at se udfordringer/problemstillinger fra den mest positive vinkel	K10
energisk	K99
villig til at arbejde hårdt og målrettet	K10
vinder og konkurrence menneske	knowledge
etik	K99
kundeservice	K99
kvalitetsbevidst	K99
stabil	K99
kold og varm madlavning	knowledge
opfyldning af buffet	K99
køkken	K99
kantine	K99
hygiejnebevis	K99
fleksibel	K99
udadvendt	K99
præsentabel	K99
tager nye udfordringer med et godt humør	S3
lede og koordinere de mange forskellige vejledningsopgaver	S3
indskrivning	K99
fastholdelsessamtaler	K99
kurser	K99
samarbejde med lærere og administration	K10
telefon- og træffetid	K99
planlægning og evaluering af kursustilbud	K10
uddannelsessektoren	knowledge
samarbejds- og organisatoriske evner	knowledge
bevare overblikket	K99
godt humør	knowledge
varetage den kliniske uddannelse af sygeplejestuderende	K10
varetage den kliniske uddannelse af 4-6 sygeplejestuderende pr	knowledge
bedside-undervisning	K99
planlægge og afvikle individuelle kliniske uddannelsesforløb	K10
planlægge og gennemføre studiesamtaler	K10
vejlede og eksaminere ved interne prøver	knowledge
planlægge og gennemføre opfølgningsmøder	K10
fastholde og videreudvikle et lærings- og studiemiljø hvor refleksion vejledning og undervisning er i fokus	S2
informere og ajourføre afsnittet om udviklingen indenfor sygeplejerskeuddannelsen	K10
dansk autorisation som sygeplejerske	K10
pædagogisk efteruddannelse svarende til 1/6 diplom	knowledge
sygeplejerskeuddannelsen	K99
engagement og interesse indenfor det kliniske såvel som pædagogiske felt	S3
kliniske såvel som pædagogiske felt	knowledge
debitor- og kreditorstyring	K99
kontering og bogføring af bilag	K10
afstemning af kasse og bankkonti og øvrige mellemregningskonti	K10
Momsindberetning	K99
kontrol og frigivelse af lønbilag	K99
regnskabsmæssig forståelse	K99
navision stat	K99
statens lønsystem	K99
arbejder med kontaktpersonsfunktion	K10
arbejder jeg-støttende	K10
arbejde med mennesker med en psykisk sygdom	S3
arbejde i et tæt tværfagligt samarbejde	K10
arbejde selvstændigt	K99
træffe de nødvendige beslutninger	K99
bevist om sin måde at kommunikere på	knowledge
praksisnærhed	K99
faglighed	K99
videreudvikling	K10
kvalitetssikring	K99
undervise	S1
Erhvervsøkonomi	K99
salg og service	K10
Samfundsfag	K99
it	K07
undervise	S1
administration	K09
økonomi	K99
ha	K99
cand.merc	K04
undervise	S1
tysk	K99
engelsk	K99
dansk	K99
Samfundsfag	K99
ba	K07
uddannelses på kandidatniveau	knowledge
dygtig	K99
engageret	K99
har lyst til at undervise	knowledge
teamorienteret	K99
indstillet på tværfagligt samarbejde	K10
humor	S3
humanistisk livssyn	K99
udadvendt	K99
skabe relationer	K99
ser forandringer og udviklingsmuligheder som en udfordring	K10
helhedsorienteret	K99
pædagogikum	K99
værtskab	K99
service	K10
kontakt til vore mange gæster	knowledge
gøre en positiv forskel	knowledge
professionel servering	K99
a la carte	K10
selskab	K99
vejlede gæster i valg af menu og vine	K10
skabe resultater som kan ses og mærkes	knowledge
fagligt stolt	K99
sætter en ære i at vore gæster får de bedste personlige oplevelser	K10
sælgende	K99
kontaktskabende	K99
velsoigneret	K99
smilende	K99
god fysik	K99
bevare overblikket i stressede situationer	K10
samarbejde på tværs af afdelinger og faggrupper	K10
ser en fordel i at have et varieret arbejdsskema med skiftende arbejdstider	S3
anerkendende	K99
imødekommende	K99
indgå i et tværfagligt team	K10
direkte plejerelateret opgaver	K10
opvarmning og anretning af aftensmad	K10
arbejde med ældre borgere på midlertidigt ophold	K99
arbejde ud fra en helhedsorienteret vinkel	K99
samarbejder ud fra et anerkendende fokus	K99
bevare roen og overblikket	K99
smilende	K99
fleksible	K06
hjælpsomme	K99
smager på maden	knowledge
dyrke madglæden og de gode råvarer	K99
mellemstort køkken	K99
Helsingør	L1
positiv af sind	K99
hjælpsom	K99
finder løsninger selvom du er presset	K10
fleksibel	K99
ser mulighederne i et frit samarbejde	K99
bespise alle slags mennesker	K99
opfordrer børnene til at være hjælpsomme hensynsfulde og positive	S3
styrke gruppefællesskabet	K10
giver børnene mulighed for medbestemmelse	S3
alsidig	K99
aktiv	K99
positiv	K99
samarbejdsorienteret	K99
godt overblik	K99
skabe en tryg og udviklende dagligdag for børnene	K99
brænder for sit fag	knowledge
musik	K99
natur	K99
udeliv	K99
orientere sig	K99
arbejde med it som værktøj	S3
fagligt velfunderet	K99
reflektere over din praksis	knowledge
opstilling af regnskaber/årsregnskaber	K10
revision	K03
moms	K99
daglig kontering	K99
kommunikation og it	K04
informatik	K99
programmering	K06
medialogi	K99
tages højde for elevens selvstændighed og personlige udvikling	K10
undervisning og planlægning i et tæt teamsamarbejde	K10
cand.scient i informatik	K03
cand.mag i multimedier humanistisk informatik	K03
computerspilsbranchen	K99
PG/pædagogikum	K99
interaktive medier	K10
programmering	K06
gamification	K99
computerspilsudvikling	K99
skabe tillid og kontakt til unge mennesker	knowledge
naturlig autoritet	K99
let ved at sætte rammer for det faglige samvær med eleverne	S3
samarbejde med kollegerne	K99
kreativ	K99
innovativ	S5
respekt for menneskers forskelligheder	knowledge
påvirke andre på en positiv måde	L1
grafiske evner	K99
kvalitetssikring af grafisk materiale	knowledge
sammensætning af 360-billeder	K99
efterbehandling af corporate billeder	K10
billedredigering	K99
InDesign	K99
photoshop	K06
detaljeorienteret	K99
effektiv	K99
arbejder selvstændigt	K99
arbejdsmoral	K99
billedbehandling	K99
fagligt dygtig	K10
engageret	K99
arbejdsmarkedspolitik	K99
statistik	K99
samfundsøkonomi	K99
stud.polit	K07
stud.scient.oecon	K03
stud.ha	K99
stærk faglig profil	knowledge
fordyber dig i og tager ansvar for de opgaver du stilles overfor	knowledge
analytiske og metodiske færdigheder	K10
skriftlige formidlingsevner	K99
kvantitative analyser	S2
arbejde dybdegående med empiriske og statistiske analyser	S3
skabe grundlag for fremtidens politikudvikling	K10
kvantitative og statistiske evalueringer	S2
analyser med brug af individdata	K99
sas	K06
statistiske værktøjer	K10
behandling af store mængder data	knowledge
gåpåmod	K99
arbejde med empirisk metode	K10
koble resultaterne til den økonomiske teori	knowledge
”ole opfinder”	L1
svejse	K99
arbejde selvstændigt	K99
flair for teknik	S2
”regne den ud”	knowledge
udvikle / designe / samle / svejse en kabine	K10
pp tråds hånd svejser	knowledge
indgå i et samarbejde	K10
trykning af ekstrakter	K10
kopiere ankesagens dokumenter	K99
vedligeholdelse af tjenestekøretøjer	K99
opsætning af udstyr	knowledge
papir- og affaldshåndtering	K99
sikre kvalitet og effektivitet i vores sagsbehandling	S3
gode evner for samarbejde	K10
serviceminded	S1
robust	K07
engageret	K99
stabil	K99
ansvarsbevidst	K99
pligtopfyldende	K99
udfører dine opgaver med høj kvalitet	S3
situationsfornemmelse	K99
fleksibel	K99
overkomme fysiske arbejdsopgaver	K99
godt humør	knowledge
kørekort til personbil b	K10
afholde status	K06
plukkes	K99
pakkes	K99
fysik i orden	knowledge
fysisk arbejde	K99
går engageret til dine arbejdsopgaver	K10
stabil	K99
pligtopfyldende	K99
går op i detaljen	K10
effektiv	K99
engelsk	K99
ordenssans	K99
grundig i dine arbejdsopgaver	K99
god fysik	K99
fysisk arbejde	K99
sætter borgeren i centrum	knowledge
lære nyt	knowledge
humoristisk sans	L1
samarbejde	K99
lungemedicin	K99
varetage specialiserede og almene lungemedicinske opgaver	S3
videreudvikle området	K10
bidrage på visionærvis og aktivt til at udvikle specialet yderligere	S3
indgå engageret i både videreudvikling og drift af det lungemedicinske speciale	S3
understøtte en kultur hvor der lægges vægt på et godt og dynamisk arbejdsmiljø	S3
kommunikative egenskaber	K99
samarbejde tværfagligt	K99
bidrage aktivt til forskning uddannelse og kvalitetsudvikling	S2
gå aktivt ind i afdelingens kvalitetsarbejde	K10
optimering af patientforløb og patient- og pårørendeinvolvering	S3
jordemoderfaget	K99
konsultationsarbejde	K99
barselsklinik	K99
ammeklinik	K99
fleksibel	K99
hjælpe med at passe svangre- og barselspatienter	K10
hjælper hinanden på tværs af afsnittene	K99
klinisk sparring	K04
vejlede studerende	knowledge
deltage i projektarbejde	K99
stan certificeret	K99
jordemoderfaglig visionær	K99
pædagogiske empatiske og kommunikative evner	S2
Glad	S6
imødekommende	K99
initiativrig	K99
fleksibel	K99
omstillingparat	K99
arbejde med at udvikle samt forbedre klinisk praksis	K10
forsknings- og udviklingsarbejde	K10
patientsikkerhed	K99
patientinvolvering	S3
rationel drift	K07
rengøring	K99
tøjvask	K99
udviklingsorienteret	K10
planlægge en inklusionsårsplan	K99
være en del af skolens ressourcecenter/pædagogisk læringscenter	knowledge
samarbejde med lærere elever forældre ledelsen samt øvrige eksterne samarbejdspersoner	S3
godt funderet skriftligt og mundtligt	knowledge
inklusionsfremmende aktiviteter	S3
arbejde selvstændigt og tværfagligt	K10
sætte din viden i spil i forhold til kolleger med forskellige faglige baggrunde	S2
mangfoldighed	K99
fællesskaber	K99
inkluderende læringsmiljøer?	K10
inkluderende læringsmiljøer	K10
omsorg	K99
kontakt	K99
udvikling af børnenes muligheder for at deltage i læringsfællesskaber ( leg klasse- og læringsrummene frikvarter	K10
være en del af skolens ressourcecenter/pædagogisk læringscenter	knowledge
udvikler en observations- og sparringskultur	K10
støtte lærerne forældrene og eleverne i et struktureret og forudsigeligt læringsmiljø	K10
sparring med lærerne	S1
stimulering og udvikling af fællesskab sociale og personlige kompetencer hos eleverne	K10
understøtte enkelte eller grupper af elever	K10
social træning	K10
samarbejde tæt med en række af skolens lærere	K10
arbejde med retningslinjer for datamodellering	K99
datamodellering	K99
gøre en forskel	knowledge
udnytte værdien af store datamængder optimalt?	K99
tænker strategisk	K99
arbejde med model- og datastandarder	K10
arbejde i tæt samspil med it-arkitekter og udviklere	S3
designe og optimere løsninger på vores nye dataplatform	S3
designe og implementere værdiskabende datamodeller	S3
udforske analytiske muligheder	K99
rådgive og støtte organisationen i strategisk anvendelse af data	S2
implementere og vedligeholde governance	K10
definere metoder og processer for udvikling og drift	S2
udvikle og implementere strategi og roadmap	K10
designe og kommunikere standarder for datamodellering og metadataregistrering	S2
støtte og køre vores data governance-program	K03
igangsætte nødvendige initiativer i projekterne	K10
engagere dig i datakvalitetskontrolprocesser	knowledge
dokumentere og vedligeholde fysisk og logisk dataarkitektur	S2
understøtte daglige issues vedrørende datadokumentation	K10
etablere og vedligeholde reference- og løsningsarkitektur	K10
målbilleder	K99
guidelines	K04
principper	K99
udnytte data på nye måder	K99
arbejde dedikeret	K99
sikre effektiv udvikling af værdiskabende løsninger	K10
information/data	K06
processer	K07
dataintegrationer	K99
implementering af nye it-løsninger	K99
arbejde på et højt abstraktionsniveau	K10
designe og/eller omsætte tekniske beskrivelser og behov til tekniske og datamæssige løsninger	S3
samarbejde	K99
sikre den nødvendige koordinering og videndeling	K10
formidler	K99
holder hovedet koldt i pressede situationer	K10
arkitektur	K99
data	K06
ny teknologi	K99
mod på at lære nyt	knowledge
arbejde projektorienteret	K99
Datamodelleringskoncepter	K99
data vault	K06
Snowflake	K99
3	K06
datamodeller på bl.a	K06
xml	K06
CSV	K99
AVRO	K99
PARQUET	K99
Arkitekturrammeværk	K99
zachman framework	K06
Datamodelleringsværktøjer	K99
ea sparks	K06
Qualiware	K99
Datakvalitetskoncepter	K99
cloud-baseret it-arkitektur eller udvikling	K10
etl	knowledge
data lake	K06
metadata registrering og lineage	knowledge
design af løsninger i en offentlig kontekst	S3
fda	K99
OIO	K99
opbygning af data flows	S5
sikre beboerne en høj livskvalitet	knowledge
omstille dig til nye rutiner	knowledge
deltage i dækningen af vagter ved sygdom	K99
arbejde med plejen af ældre	K10
arbejde med at dokumentere	K99
KOS2	K99
betjene psykiatrisk center	K09
tjeneste	K99
udadvendt	K99
energi- og kraftværksområdet	S2
projektledelse af teknisk komplicerede og udfordrende energianlæg	K10
-biomassekonvertering af fossilfyrede kraftværker	K99
-optimering af kraftværker og anlæg	K10
-projektering af nye kraftværksanlæg	K10
-drift- og vedligeholdelse af anlæg	K10
task force indsats	S4
haverier	K99
due diligence projekter	S1
feasibility studier	S2
strategi indsatser	K99
arbejde tæt sammen med kunder	K99
opbygge gode relationer til netværk	K10
arbejde i et dynamisk miljø	K10
interesse for at udvikle dig	knowledge
energi	K99
kraftværker	K99
miljø	K10
energiområdet	K99
projektledelse	K99
energiområdet	K99
byggeri og anlæg	L1
strukturere projektets faser	K10
sikre effektiv projektafvikling	K10
projektering/projektledelse	K10
komplette projektforløb	K99
planlægning	K99
projektering af anlæg	K10
udbud samt tilsyn	K99
projekt- og byggeledelse	K99
kraftværker	K99
miljøanlæg	K10
kontekst- og forretningsforståelse	K99
arbejde systematisk	K10
arbejde i et internationalt miljø	K10
dansk	K99
engelsk	K99
frisk sælgende personlighed?	K10
kontakte virksomhedsledere og andre ansættende ledere i mindre og mellemstore virksomheder	S3
arbejder selvstændigt	K99
højt aktivitetsniveau	K99
salgsdialoger	K99
skaffe nye kunder i butikken	K99
god energi	K99
indstilling til at ville lykkes	K10
vindermentalitet	K99
motiveres af et ja tak	knowledge
ikke lader dig slå ud af et nej tak	S5
social	S1
skaber en god stemning	knowledge
New Bizz	K99
bagerfaget	K99
kvalificeret	K99
energisk	K99
reservedels indkøb håndtering udlevering og salg	K10
værkstedsplanlægning	K99
indskrivning	K99
skadekoordinering med eksternt pladeværksted	S3
telefonekspedition	K99
Engageret	K99
selvstændig	K99
ansvarlig	K10
serviceminded	S1
Dracar+	K99
Suzuki	K99
sælge produkter	K03
tillid	K99
loyalitet	K99
smil	K99
positiv energi	K99
samarbejde	K99
koordinering	K99
positiv indstilling til samarbejde problemløsning og tilgang til andre mennesker	S3
pet/ct	K07
spect	K99
fysiologi	K99
kombinere fysiologi med anatomi	K03
anatomi	K99
diagnostik	K09
stadieinddeling af sygdomme	K99
terapimonitorering	K99
matematiske begavelse	K99
visuelle betragtende hjerne	knowledge
behandling med radioaktive lægemidler	S3
visitation	K99
beskrivelser af forskellige typer undersøgelser	K99
fysiologisk og/eller medikamentel belastning af hjertet	S3
hjerteperfusionsundersøgelser	K99
klinisk fysiologi	K09
nuklearmedicin	K99
abcde principperne	K99
måle værdier	K99
måle crp hæmoglobin og leucocyter	knowledge
stixe urin	K99
tage dyrkninger	K99
sonde	K99
urin-kateter	K99
pvk	K99
CVK	K99
sc-nål	K99
hjerte lunge speciale	K10
forebygge indlæggelser	K99
sikre tæt samarbejde med relevante samarbejdspartnere	S3
skabe høj kvalitet i borgerens behandlingsforløb	knowledge
understøtte en ensartet og høj kvalitet på tværs af sektorer	knowledge
sektorovergange	K99
relationskompetencer	K10
faglig nysgerrighed	K99
varetagelse af sygeplejeopgaver	K99
håndtering af ustabile borgere	K99
arbejde løsningsorienteret	K10
arbejde selvstændigt	K99
tage beslutninger i pressede situationer	S3
fejlfinding på og reparation af produktionsmaskiner	K99
forebyggende vedligehold	K99
planlægning af større eftersyn	K10
tilsyn og planlægning af arbejdsopgaver for eksterne håndværkere	K10
optimering af produktionsudstyr	K99
projektarbejde	K99
teknisk profil	K06
el arbejde	K99
procesteknisk forståelse	K10
større rørinstallationer	K10
regulering af tryk og flow	K07
el-styringer	K99
industrigasser	K99
prioritere	K99
planlægge	K99
overblik	K99
arbejder struktureret og pligtopfyldende	K10
kommunikations- og samarbejdsevner	K99
positiv	K99
engageret	K99
arbejder selvstændigt og kvalitetsbevist	K10
fokus på overholdelse af deadlines	K99
bidrager til et højt sikkerhedsniveau	knowledge
godt humør	knowledge
søge og dele viden	K10
engelsk	K99
it	K07
inspirere	K99
udfordre	K99
rumme	K99
aktiv medspiller	K99
anerkende tilgang	K99
respekterer og gerne udfordrer kollegers idéer og pædagogiske arbejde	K10
ledelse	K99
personaleledelse	K99
samarbejde	K99
drive og videreudvikle et rigtig godt børnehus	knowledge
trivsel	K99
lede en integreret institution	K10
faglighed	K99
lytte	K99
reflektere	K99
omsætte visioner til handling	K10
lydhør	K99
inddrager kolleger	K10
træffe beslutninger	K99
gå forrest	knowledge
overblik	K99
rummer samtidig nærvær og de små detaljer	K99
arbejde videre med mange af de tiltag vi allerede har i gang	K99
inspirerer også til kommende tiltag	knowledge
synlig i huset	K10
trives med de forskellige aspekter jobbet byder på	knowledge
ledelsesopgaver	K99
dialogbaseret	K99
anerkendende	K99
videreformidle	K99
inspirere	K99
kommunikerer ligeværdigt imødekommende og med tydelighed	S3
it-systemer	K99
humor	S3
humør	K99
skabe det gode børneliv	K99
indgå i et mindre sjak	K10
vejen som arbejdsplads	K99
kloak	K99
fiber	K07
fjernvarme	K99
Håndmandsarbejde	K99
vejen som arbejdspalds	K99
fjernvarme	K99
kloak	K99
fiber	K07
dansk	K99
troværdigt og inspirerende sætte retning	S3
stå i spidsen	K99
skabe engagement og følgeskab	K10
skabe en stabil og autentisk forbindelse	knowledge
sætte dagsordenen	knowledge
være værdiskabende	K99
levere skarpt fagligt og strategisk med- og modspil	S3
matche kravene til ledelse af den faglige indsats forhandlinger håndtering af vanskelige sager	S3
lang videregående uddannelse	K10
juridisk kompetence	K99
robust	K07
gennemslagskraft	K99
direkte ledelse	knowledge
ledelse af ledere	K10
ledelse	K99
personalejura	K99
arbejdsmiljø	K10
kompetence- og organisationsudvikling	K10
tillidsfuldt og konstruktivt samarbejde	K99
integritet	K99
ordentlighed	K99
loyalitet	K99
sikre såvel kompetent ledelse udvikling og styring af egen afdeling som den tværgående strategiske udvikling af hele organisationen	K10
hr-området	K99
telefonkontakt internt og eksternt	K03
administration for caféerne	K09
behandle og bogføre diners eurocard og pbs	K10
kronisk medicinsk speciale	K03
