bredtorienteret	K99
varetage opbygning og drift af servicefunktioner	A1
indgå i et team	0000
alsidig	K99
renovering- og restaureringsopgaver	S6
Reperationsarbejder	K99
Flisearbejder	S6
Tagarbejder	K99
imuring af rygninge og grater	S6
fagudlært murer	S6
brænde for dit fag	S5
arbejde selvstændigt	S6
kundemindet	K99
arbejde sammen på tværs af faggrænser	S6
kørekort b og gerne be	S6
ledelseserfaring	K99
kvik	K99
arbejde selvstændigt	S6
kan lide at have travlt	S6
min tid	K07
arbejde med komplicerede patientforløb	S6
omsorg	K99
kol-team	K02
diabetes mellitus	K09
kol	K99
niv ( non invasiv ventilation	K07
lomholt-system	K07
clinical suite	K06
engageret	K99
korrespondance	K99
post	K04
arkivering	K99
bogføring	K99
regnskabsmæssige opgaver	S3
personalerelaterede opgaver	S5
administrativt sagsarbejde	K99
indkøb af kontorartikler	S6
vedligeholdelse af intranet og hjemmeside	S3
kontoruddannet	K99
it	K07
bogføring	K99
arbejdet i en kommune	S6
åben	K99
udadvendt	K99
bevare overblikket og begge ben på jorden	S6
velformuleret	K99
omstillingsparat	K99
fleksibel	K99
godt humør	S5
opus	K06
skrivning af notater i opus fra mirsk	S6
MIRSK	K99
opus	K06
ris	S1
LABKA	K05
indkaldelse af patienter	S6
finde journaler frem til ugeprogram	S6
oplæring af elever	A1
Officepakken	K99
GSÅben	K99
opus notat	K02
epikrise	K99
MIRSK	K99
orbit	K07
Labka	K05
ris	S1
godt humør	S5
kan lide at have travlt	S6
robust	K07
arbejde i et team	S6
en 473/	K99
endoskopi	K99
Olympus Iplex	K99
selvstændigt	K99
rejsevant	K99
bidrage til fremtidig udvikling?	S6
dygtigste	K99
effektive	K99
strukturerede	K99
herlig men stærk og udadvendt kommunikerende personlighed	S5
godt humør	S5
let til smil	K99
går altid foran med dit eksempel	S6
høj stresstærskel	S6
have mangebolde i luften	S6
initiativrig	K99
løsningsorienteret	S3
effektiv	K99
bevare overblikket	K99
struktureret	K99
trives i travl omskiftelig hverdag	S6
lagererfaring	K99
rengøringsartikler	K99
ledererfaring	K99
klar til en stor udfordring	S6
jernvilje	K99
personligt drive	S1
få styr på lageret	S2
deltager aktivt i den daglige drift	S5
varemodtagelse	K99
pluk og pak	S6
forsendelse	K99
rengøring i butik ,slagter og bager	S6
stabil	K99
grundig	K99
Kvalitetsbevist	S6
Serviceminded	S1
arbejde selvstændig og i team	S4
dansk	K04
øge kvaliteten	S2
sænke omkostningsniveauet	S6
ledererfaring	K99
økonomi	K99
it og statistik	K03
løn- og personaleadministration	S3
realisere visionen	S3
sikre en stærk ledelse af myndighedsopgaverne	S2
varetage dialogen	K05
løn og personale	S4
regnskab	K99
ledelsesinformation	K99
it	K07
strategisk sans	K06
ledererfaring	K99
akademisk uddannelse	S2
lederuddannelse	S6
forretningsforståelse	S6
levere stærke strategiske bud	S2
udadvendte facon	S6
personlige pondus	S1
skabe gode relationer til samarbejdspartnere	S6
fastholde en naturlig gennemslagskraft	S6
skabe et inspirerende arbejdsmiljø	S2
motivere dine medarbejdere	S6
levere synlige resultater	S6
dygtig	K99
engageret	K99
frisk	K99
engageret	K99
udadvendt	K99
godt humør	S5
klar til at lære nyt	S5
arbejde med computer	S5
servicere vores web-butik	S5
service og kvalitets orienteret?	K10
serviceminded	S1
selvstændig	K99
ansvarsbevidst	K99
Diners	S3
Eurocard	K99
Fakturere	K99
fakturere samt følge op på debitorer	S6
bogføre indbetalinger	K99
have overblik over de forskellige konti for caféerne	S6
videreudvikling at rutiner og systemer	S6
regnskab	K99
administration	K09
giver venlig service overfor vores leverandrøre medarbejdere	A1
bevarer overblikket i hverdagen	S6
arbejde selvstændigt	S6
god til at samarbejde	S6
office-pakken	K02
har lyst til forandring udvikling	A1
bevare overblikket i stressede situationer	S6
forene basal sygepleje og højteknologi	S6
arbejde bevidst med faglige og personlige kompetencer	S6
handlekraftig	S6
påtage dig ansvar	S6
være i meget tæt kontakt med patienter og pårørende	S5
turde gøre en forskel	S5
blive udfordret på etiske overvejelser	S6
bidrage til udvikling af sygeplejen	S6
gå i front	K99
gå på akut kald	S5
samarbejde på tværs af et stort hospital	K09
telefonisk kundeservice og salg	K99
flair for it	S2
høj stress tærskel	S6
skarp i en dialog	K06
salgsminded	K99
tager ejerskab over dit arbejde	S6
vælger at se udfordringer/problemstillinger fra den mest positive vinkel	S6
energisk	K99
villig til at arbejde hårdt og målrettet	S5
vinder og konkurrence menneske	S5
etik	K02
kundeservice	K99
kvalitetsbevidst	S6
stabil	K99
kold og varm madlavning	S5
opfyldning af buffet	S6
køkken	K99
kantine	K99
hygiejnebevis	K99
fleksibel	K99
udadvendt	K99
præsentabel	K99
tager nye udfordringer med et godt humør	S5
lede og koordinere de mange forskellige vejledningsopgaver	S2
indskrivning	K99
fastholdelsessamtaler	K99
kurser	K99
samarbejde med lærere og administration	S3
telefon- og træffetid	S5
planlægning og evaluering af kursustilbud	S5
uddannelsessektoren	K02
samarbejds- og organisatoriske evner	S6
bevare overblikket	K99
godt humør	S5
varetage den kliniske uddannelse af sygeplejestuderende	S6
varetage den kliniske uddannelse af 4-6 sygeplejestuderende pr	K08
bedside-undervisning	K01
planlægge og afvikle individuelle kliniske uddannelsesforløb	S2
planlægge og gennemføre studiesamtaler	S6
vejlede og eksaminere ved interne prøver	S5
planlægge og gennemføre opfølgningsmøder	S4
fastholde og videreudvikle et lærings- og studiemiljø hvor refleksion vejledning og undervisning er i fokus	S2
informere og ajourføre afsnittet om udviklingen indenfor sygeplejerskeuddannelsen	S4
dansk autorisation som sygeplejerske	S6
pædagogisk efteruddannelse svarende til 1/6 diplom	knowledge
sygeplejerskeuddannelsen	S6
engagement og interesse indenfor det kliniske såvel som pædagogiske felt	S6
kliniske såvel som pædagogiske felt	S6
debitor- og kreditorstyring	S4
kontering og bogføring af bilag	S6
afstemning af kasse og bankkonti og øvrige mellemregningskonti	S6
Momsindberetning	K99
kontrol og frigivelse af lønbilag	knowledge
regnskabsmæssig forståelse	S6
navision stat	K99
statens lønsystem	K99
arbejder med kontaktpersonsfunktion	S2
arbejder jeg-støttende	S6
arbejde med mennesker med en psykisk sygdom	S2
arbejde i et tæt tværfagligt samarbejde	S6
arbejde selvstændigt	S6
træffe de nødvendige beslutninger	S6
bevist om sin måde at kommunikere på	S6
praksisnærhed	K99
faglighed	K99
videreudvikling	K99
kvalitetssikring	S4
undervise	S1
Erhvervsøkonomi	K99
salg og service	K10
Samfundsfag	K99
it	K07
undervise	S1
administration	K09
økonomi	K99
ha	K99
cand.merc	K04
undervise	S1
tysk	K99
engelsk	K99
dansk	K04
Samfundsfag	K99
ba	K06
uddannelses på kandidatniveau	K04
dygtig	K99
engageret	K99
har lyst til at undervise	S6
teamorienteret	K99
indstillet på tværfagligt samarbejde	A1
humor	S1
humanistisk livssyn	K02
udadvendt	K99
skabe relationer	K99
ser forandringer og udviklingsmuligheder som en udfordring	A1
helhedsorienteret	K99
pædagogikum	K02
værtskab	K99
service	S3
kontakt til vore mange gæster	S5
gøre en positiv forskel	S5
professionel servering	K99
a la carte	K10
selskab	K99
vejlede gæster i valg af menu og vine	S6
skabe resultater som kan ses og mærkes	S6
fagligt stolt	S2
sætter en ære i at vore gæster får de bedste personlige oplevelser	S5
sælgende	K99
kontaktskabende	K99
velsoigneret	K99
smilende	K99
god fysik	K99
bevare overblikket i stressede situationer	S6
samarbejde på tværs af afdelinger og faggrupper	S6
ser en fordel i at have et varieret arbejdsskema med skiftende arbejdstider	S6
anerkendende	K99
imødekommende	K99
indgå i et tværfagligt team	S6
direkte plejerelateret opgaver	S6
opvarmning og anretning af aftensmad	A1
arbejde med ældre borgere på midlertidigt ophold	S5
arbejde ud fra en helhedsorienteret vinkel	S6
samarbejder ud fra et anerkendende fokus	S6
bevare roen og overblikket	S6
smilende	K99
fleksible	K06
hjælpsomme	K99
smager på maden	K06
dyrke madglæden og de gode råvarer	S6
mellemstort køkken	knowledge
Helsingør	K99
positiv af sind	S5
hjælpsom	K99
finder løsninger selvom du er presset	S6
fleksibel	K99
ser mulighederne i et frit samarbejde	S6
bespise alle slags mennesker	S6
opfordrer børnene til at være hjælpsomme hensynsfulde og positive	S3
styrke gruppefællesskabet	S6
giver børnene mulighed for medbestemmelse	S6
alsidig	K99
aktiv	K99
positiv	K99
samarbejdsorienteret	K99
godt overblik	K99
skabe en tryg og udviklende dagligdag for børnene	S6
brænder for sit fag	S6
musik	K99
natur	K99
udeliv	K99
orientere sig	S6
arbejde med it som værktøj	S6
fagligt velfunderet	S2
reflektere over din praksis	S6
opstilling af regnskaber/årsregnskaber	S6
revision	K07
moms	K99
daglig kontering	S6
kommunikation og it	S5
informatik	K04
programmering	S5
medialogi	K99
tages højde for elevens selvstændighed og personlige udvikling	S6
undervisning og planlægning i et tæt teamsamarbejde	S2
cand.scient i informatik	K03
cand.mag i multimedier humanistisk informatik	K03
computerspilsbranchen	K99
PG/pædagogikum	K02
interaktive medier	K02
programmering	S5
gamification	K99
computerspilsudvikling	K99
skabe tillid og kontakt til unge mennesker	A1
naturlig autoritet	K99
let ved at sætte rammer for det faglige samvær med eleverne	S5
samarbejde med kollegerne	S6
kreativ	K99
innovativ	K99
respekt for menneskers forskelligheder	S6
påvirke andre på en positiv måde	S6
grafiske evner	K99
kvalitetssikring af grafisk materiale	S2
sammensætning af 360-billeder	S6
efterbehandling af corporate billeder	S6
billedredigering	K99
InDesign	K99
photoshop	K06
detaljeorienteret	K99
effektiv	K99
arbejder selvstændigt	S6
arbejdsmoral	K99
billedbehandling	S6
fagligt dygtig	S6
engageret	K99
arbejdsmarkedspolitik	K99
statistik	K99
samfundsøkonomi	K99
stud.polit	K03
stud.scient.oecon	K03
stud.ha	K07
stærk faglig profil	S2
fordyber dig i og tager ansvar for de opgaver du stilles overfor	S6
analytiske og metodiske færdigheder	S6
skriftlige formidlingsevner	S5
kvantitative analyser	S2
arbejde dybdegående med empiriske og statistiske analyser	S6
skabe grundlag for fremtidens politikudvikling	S6
kvantitative og statistiske evalueringer	S2
analyser med brug af individdata	S6
sas	K06
statistiske værktøjer	A2
behandling af store mængder data	S6
gåpåmod	K99
arbejde med empirisk metode	S6
koble resultaterne til den økonomiske teori	S6
”ole opfinder”	S5
svejse	K99
arbejde selvstændigt	S6
flair for teknik	S2
”regne den ud”	S6
udvikle / designe / samle / svejse en kabine	S6
pp tråds hånd svejser	K02
indgå i et samarbejde	S6
trykning af ekstrakter	S6
kopiere ankesagens dokumenter	S6
vedligeholdelse af tjenestekøretøjer	S6
opsætning af udstyr	S5
papir- og affaldshåndtering	S6
sikre kvalitet og effektivitet i vores sagsbehandling	S2
gode evner for samarbejde	S6
serviceminded	S1
robust	K07
engageret	K99
stabil	K99
ansvarsbevidst	K99
pligtopfyldende	K99
udfører dine opgaver med høj kvalitet	S5
situationsfornemmelse	K99
fleksibel	K99
overkomme fysiske arbejdsopgaver	S6
godt humør	S5
kørekort til personbil b	S6
afholde status	K10
plukkes	K99
pakkes	K99
fysik i orden	K02
fysisk arbejde	K99
går engageret til dine arbejdsopgaver	S6
stabil	K99
pligtopfyldende	K99
går op i detaljen	S6
effektiv	K99
engelsk	K99
ordenssans	K99
grundig i dine arbejdsopgaver	S6
god fysik	K99
fysisk arbejde	K99
sætter borgeren i centrum	S6
lære nyt	S5
humoristisk sans	L1
samarbejde	K99
lungemedicin	K99
varetage specialiserede og almene lungemedicinske opgaver	S2
videreudvikle området	K99
bidrage på visionærvis og aktivt til at udvikle specialet yderligere	S6
indgå engageret i både videreudvikling og drift af det lungemedicinske speciale	knowledge
understøtte en kultur hvor der lægges vægt på et godt og dynamisk arbejdsmiljø	S2
kommunikative egenskaber	K99
samarbejde tværfagligt	K99
bidrage aktivt til forskning uddannelse og kvalitetsudvikling	S4
gå aktivt ind i afdelingens kvalitetsarbejde	S6
optimering af patientforløb og patient- og pårørendeinvolvering	S3
jordemoderfaget	K99
konsultationsarbejde	K99
barselsklinik	knowledge
ammeklinik	K99
fleksibel	K99
hjælpe med at passe svangre- og barselspatienter	S6
hjælper hinanden på tværs af afsnittene	S5
klinisk sparring	K09
vejlede studerende	K04
deltage i projektarbejde	S6
stan certificeret	K99
jordemoderfaglig visionær	S6
pædagogiske empatiske og kommunikative evner	S5
Glad	K99
imødekommende	K99
initiativrig	K99
fleksibel	K99
omstillingparat	K99
arbejde med at udvikle samt forbedre klinisk praksis	S6
forsknings- og udviklingsarbejde	S4
patientsikkerhed	K99
patientinvolvering	K99
rationel drift	K99
rengøring	K99
tøjvask	K99
udviklingsorienteret	K99
planlægge en inklusionsårsplan	S5
være en del af skolens ressourcecenter/pædagogisk læringscenter	S3
samarbejde med lærere elever forældre ledelsen samt øvrige eksterne samarbejdspersoner	S3
godt funderet skriftligt og mundtligt	S4
inklusionsfremmende aktiviteter	S6
arbejde selvstændigt og tværfagligt	S6
sætte din viden i spil i forhold til kolleger med forskellige faglige baggrunde	A1
mangfoldighed	K99
fællesskaber	K99
inkluderende læringsmiljøer?	S2
inkluderende læringsmiljøer	S2
omsorg	K99
kontakt	K99
udvikling af børnenes muligheder for at deltage i læringsfællesskaber ( leg klasse- og læringsrummene frikvarter	A2
være en del af skolens ressourcecenter/pædagogisk læringscenter	S3
udvikler en observations- og sparringskultur	S5
støtte lærerne forældrene og eleverne i et struktureret og forudsigeligt læringsmiljø	S2
sparring med lærerne	S1
stimulering og udvikling af fællesskab sociale og personlige kompetencer hos eleverne	S2
understøtte enkelte eller grupper af elever	S5
social træning	S6
samarbejde tæt med en række af skolens lærere	S6
arbejde med retningslinjer for datamodellering	S5
datamodellering	K99
gøre en forskel	S5
udnytte værdien af store datamængder optimalt?	S6
tænker strategisk	S6
arbejde med model- og datastandarder	S6
arbejde i tæt samspil med it-arkitekter og udviklere	S6
designe og optimere løsninger på vores nye dataplatform	S5
designe og implementere værdiskabende datamodeller	S2
udforske analytiske muligheder	K02
rådgive og støtte organisationen i strategisk anvendelse af data	S2
implementere og vedligeholde governance	S4
definere metoder og processer for udvikling og drift	S6
udvikle og implementere strategi og roadmap	K08
designe og kommunikere standarder for datamodellering og metadataregistrering	S2
støtte og køre vores data governance-program	K03
igangsætte nødvendige initiativer i projekterne	A1
engagere dig i datakvalitetskontrolprocesser	S6
dokumentere og vedligeholde fysisk og logisk dataarkitektur	S6
understøtte daglige issues vedrørende datadokumentation	S2
etablere og vedligeholde reference- og løsningsarkitektur	S6
målbilleder	K99
guidelines	K04
principper	K99
udnytte data på nye måder	K06
arbejde dedikeret	S6
sikre effektiv udvikling af værdiskabende løsninger	S6
information/data	K06
processer	K02
dataintegrationer	K99
implementering af nye it-løsninger	S6
arbejde på et højt abstraktionsniveau	S5
designe og/eller omsætte tekniske beskrivelser og behov til tekniske og datamæssige løsninger	K08
samarbejde	K99
sikre den nødvendige koordinering og videndeling	S2
formidler	K99
holder hovedet koldt i pressede situationer	S6
arkitektur	K99
data	K06
ny teknologi	K99
mod på at lære nyt	S5
arbejde projektorienteret	S6
Datamodelleringskoncepter	K99
data vault	K06
Snowflake	K99
3	K06
datamodeller på bl.a	K06
xml	K06
CSV	K99
AVRO	K99
PARQUET	K99
Arkitekturrammeværk	S6
zachman framework	K06
Datamodelleringsværktøjer	K99
ea sparks	K06
Qualiware	K99
Datakvalitetskoncepter	K99
cloud-baseret it-arkitektur eller udvikling	knowledge
etl	knowledge
data lake	K06
metadata registrering og lineage	knowledge
design af løsninger i en offentlig kontekst	S6
fda	K99
OIO	K99
opbygning af data flows	S5
sikre beboerne en høj livskvalitet	S5
omstille dig til nye rutiner	S5
deltage i dækningen af vagter ved sygdom	S5
arbejde med plejen af ældre	S2
arbejde med at dokumentere	S6
KOS2	K99
betjene psykiatrisk center	K09
tjeneste	K99
udadvendt	K99
energi- og kraftværksområdet	S6
projektledelse af teknisk komplicerede og udfordrende energianlæg	S2
-biomassekonvertering af fossilfyrede kraftværker	S6
-optimering af kraftværker og anlæg	S5
-projektering af nye kraftværksanlæg	S6
-drift- og vedligeholdelse af anlæg	S6
task force indsats	S4
haverier	K10
due diligence projekter	S1
feasibility studier	S2
strategi indsatser	K99
arbejde tæt sammen med kunder	S6
opbygge gode relationer til netværk	S6
arbejde i et dynamisk miljø	S2
interesse for at udvikle dig	S6
energi	K99
kraftværker	K99
miljø	S2
energiområdet	K99
projektledelse	S6
energiområdet	K99
byggeri og anlæg	S6
strukturere projektets faser	S6
sikre effektiv projektafvikling	S6
projektering/projektledelse	S6
komplette projektforløb	K99
planlægning	S6
projektering af anlæg	S6
udbud samt tilsyn	S5
projekt- og byggeledelse	S6
kraftværker	K99
miljøanlæg	K10
kontekst- og forretningsforståelse	S6
arbejde systematisk	K04
arbejde i et internationalt miljø	S5
dansk	K04
engelsk	K99
frisk sælgende personlighed?	S6
kontakte virksomhedsledere og andre ansættende ledere i mindre og mellemstore virksomheder	S3
arbejder selvstændigt	S6
højt aktivitetsniveau	S5
salgsdialoger	K99
skaffe nye kunder i butikken	S6
god energi	K99
indstilling til at ville lykkes	A1
vindermentalitet	S5
motiveres af et ja tak	S5
ikke lader dig slå ud af et nej tak	S5
social	S1
skaber en god stemning	S6
New Bizz	K99
bagerfaget	K99
kvalificeret	K99
energisk	K99
reservedels indkøb håndtering udlevering og salg	S6
værkstedsplanlægning	S6
indskrivning	K99
skadekoordinering med eksternt pladeværksted	S6
telefonekspedition	K99
Engageret	K99
selvstændig	K99
ansvarlig	S5
serviceminded	S1
Dracar+	K99
Suzuki	K99
sælge produkter	K02
tillid	K99
loyalitet	K99
smil	K99
positiv energi	K99
samarbejde	K99
koordinering	K99
positiv indstilling til samarbejde problemløsning og tilgang til andre mennesker	S3
pet/ct	K10
spect	K99
fysiologi	K99
kombinere fysiologi med anatomi	K03
anatomi	K99
diagnostik	K99
stadieinddeling af sygdomme	S6
terapimonitorering	K99
matematiske begavelse	K02
visuelle betragtende hjerne	S5
behandling med radioaktive lægemidler	S6
visitation	K99
beskrivelser af forskellige typer undersøgelser	S6
fysiologisk og/eller medikamentel belastning af hjertet	K09
hjerteperfusionsundersøgelser	K99
klinisk fysiologi	K03
nuklearmedicin	K99
abcde principperne	K99
måle værdier	K02
måle crp hæmoglobin og leucocyter	A2
stixe urin	K99
tage dyrkninger	S6
sonde	K99
urin-kateter	K02
pvk	K99
CVK	K99
sc-nål	K99
hjerte lunge speciale	K10
forebygge indlæggelser	S6
sikre tæt samarbejde med relevante samarbejdspartnere	S3
skabe høj kvalitet i borgerens behandlingsforløb	A1
understøtte en ensartet og høj kvalitet på tværs af sektorer	S6
sektorovergange	K99
relationskompetencer	K99
faglig nysgerrighed	K99
varetagelse af sygeplejeopgaver	S6
håndtering af ustabile borgere	S6
arbejde løsningsorienteret	S3
arbejde selvstændigt	S6
tage beslutninger i pressede situationer	S6
fejlfinding på og reparation af produktionsmaskiner	S6
forebyggende vedligehold	S6
planlægning af større eftersyn	S6
tilsyn og planlægning af arbejdsopgaver for eksterne håndværkere	S6
optimering af produktionsudstyr	S5
projektarbejde	K99
teknisk profil	K06
el arbejde	K99
procesteknisk forståelse	K02
større rørinstallationer	K10
regulering af tryk og flow	S6
el-styringer	K99
industrigasser	K99
prioritere	K99
planlægge	S6
overblik	K99
arbejder struktureret og pligtopfyldende	S6
kommunikations- og samarbejdsevner	S4
positiv	K99
engageret	K99
arbejder selvstændigt og kvalitetsbevist	S6
fokus på overholdelse af deadlines	S6
bidrager til et højt sikkerhedsniveau	S5
godt humør	S5
søge og dele viden	A1
engelsk	K99
it	K07
inspirere	K99
udfordre	K99
rumme	K99
aktiv medspiller	K99
anerkende tilgang	A1
respekterer og gerne udfordrer kollegers idéer og pædagogiske arbejde	K02
ledelse	K99
personaleledelse	K99
samarbejde	K99
drive og videreudvikle et rigtig godt børnehus	S2
trivsel	K99
lede en integreret institution	A1
faglighed	K99
lytte	K99
reflektere	K99
omsætte visioner til handling	A1
lydhør	K99
inddrager kolleger	S6
træffe beslutninger	S6
gå forrest	K99
overblik	K99
rummer samtidig nærvær og de små detaljer	S5
arbejde videre med mange af de tiltag vi allerede har i gang	S6
inspirerer også til kommende tiltag	S2
synlig i huset	S6
trives med de forskellige aspekter jobbet byder på	S5
ledelsesopgaver	K99
dialogbaseret	K99
anerkendende	K99
videreformidle	K99
inspirere	K99
kommunikerer ligeværdigt imødekommende og med tydelighed	S6
it-systemer	K99
humor	S1
humør	K99
skabe det gode børneliv	S5
indgå i et mindre sjak	S6
vejen som arbejdsplads	S6
kloak	K99
fiber	K07
fjernvarme	K99
Håndmandsarbejde	K99
vejen som arbejdspalds	S6
fjernvarme	K99
kloak	K99
fiber	K07
dansk	K04
troværdigt og inspirerende sætte retning	S3
stå i spidsen	K99
skabe engagement og følgeskab	K08
skabe en stabil og autentisk forbindelse	K08
sætte dagsordenen	S6
være værdiskabende	S6
levere skarpt fagligt og strategisk med- og modspil	S6
matche kravene til ledelse af den faglige indsats forhandlinger håndtering af vanskelige sager	S6
lang videregående uddannelse	S6
juridisk kompetence	K99
robust	K07
gennemslagskraft	K99
direkte ledelse	K02
ledelse af ledere	K02
ledelse	K99
personalejura	K99
arbejdsmiljø	K99
kompetence- og organisationsudvikling	K08
tillidsfuldt og konstruktivt samarbejde	S6
integritet	K99
ordentlighed	K99
loyalitet	K99
sikre såvel kompetent ledelse udvikling og styring af egen afdeling som den tværgående strategiske udvikling af hele organisationen	K08
hr-området	K99
telefonkontakt internt og eksternt	K02
administration for caféerne	S6
behandle og bogføre diners eurocard og pbs	S6
kronisk medicinsk speciale	K09
