bredtorienteret	K99
varetage opbygning og drift af servicefunktioner	L1
indgå i et team	L1
alsidig	K99
renovering- og restaureringsopgaver	K99
Reperationsarbejder	K99
Flisearbejder	K99
Tagarbejder	K99
imuring af rygninge og grater	S6
fagudlært murer	L1
brænde for dit fag	L1
arbejde selvstændigt	K99
kundemindet	K99
arbejde sammen på tværs af faggrænser	L1
kørekort b og gerne be	L1
ledelseserfaring	K99
kvik	K99
arbejde selvstændigt	K99
kan lide at have travlt	K99
min tid	S8
arbejde med komplicerede patientforløb	K99
omsorg	K99
kol-team	K02
diabetes mellitus	K09
kol	K99
niv ( non invasiv ventilation	K07
lomholt-system	K07
clinical suite	K06
engageret	K99
korrespondance	K99
post	K09
arkivering	K99
bogføring	K99
regnskabsmæssige opgaver	K99
personalerelaterede opgaver	K99
administrativt sagsarbejde	K99
indkøb af kontorartikler	K99
vedligeholdelse af intranet og hjemmeside	L1
kontoruddannet	K99
it	K07
bogføring	K99
arbejdet i en kommune	L1
åben	K99
udadvendt	K99
bevare overblikket og begge ben på jorden	L1
velformuleret	K99
omstillingsparat	K99
fleksibel	K99
godt humør	L1
opus	K06
skrivning af notater i opus fra mirsk	L1
MIRSK	K99
opus	K06
ris	S1
LABKA	K99
indkaldelse af patienter	L1
finde journaler frem til ugeprogram	S6
oplæring af elever	L1
Officepakken	K99
GSÅben	K99
opus notat	K03
epikrise	K99
MIRSK	K99
orbit	K10
Labka	K99
ris	S1
godt humør	L1
kan lide at have travlt	K99
robust	K07
arbejde i et team	L1
en 473/	K99
endoskopi	K99
Olympus Iplex	K99
selvstændigt	K99
rejsevant	K99
bidrage til fremtidig udvikling?	S6
dygtigste	K99
effektive	K99
strukturerede	K99
herlig men stærk og udadvendt kommunikerende personlighed	L1
godt humør	L1
let til smil	K99
går altid foran med dit eksempel	L1
høj stresstærskel	K99
have mangebolde i luften	S6
initiativrig	K99
løsningsorienteret	K99
effektiv	K99
bevare overblikket	K99
struktureret	K99
trives i travl omskiftelig hverdag	K99
lagererfaring	K99
rengøringsartikler	K99
ledererfaring	K99
klar til en stor udfordring	L1
jernvilje	K99
personligt drive	S1
få styr på lageret	L1
deltager aktivt i den daglige drift	L1
varemodtagelse	K99
pluk og pak	knowledge
forsendelse	K99
rengøring i butik ,slagter og bager	L1
stabil	K99
grundig	K99
Kvalitetsbevist	K99
Serviceminded	S1
arbejde selvstændig og i team	L1
dansk	K99
øge kvaliteten	L1
sænke omkostningsniveauet	K99
ledererfaring	K99
økonomi	K99
it og statistik	K09
løn- og personaleadministration	S4
realisere visionen	S3
sikre en stærk ledelse af myndighedsopgaverne	S3
varetage dialogen	L1
løn og personale	A2
regnskab	K99
ledelsesinformation	K99
it	K07
strategisk sans	K06
ledererfaring	K99
akademisk uddannelse	K04
lederuddannelse	L1
forretningsforståelse	K99
levere stærke strategiske bud	L1
udadvendte facon	K99
personlige pondus	S1
skabe gode relationer til samarbejdspartnere	L1
fastholde en naturlig gennemslagskraft	K99
skabe et inspirerende arbejdsmiljø	S3
motivere dine medarbejdere	S3
levere synlige resultater	L1
dygtig	K99
engageret	K99
frisk	K99
engageret	K99
udadvendt	K99
godt humør	L1
klar til at lære nyt	L1
arbejde med computer	L1
servicere vores web-butik	S6
service og kvalitets orienteret?	K04
serviceminded	S1
selvstændig	K99
ansvarsbevidst	K99
Diners	K10
Eurocard	K99
Fakturere	K99
fakturere samt følge op på debitorer	L1
bogføre indbetalinger	K99
have overblik over de forskellige konti for caféerne	S6
videreudvikling at rutiner og systemer	L1
regnskab	K99
administration	K09
giver venlig service overfor vores leverandrøre medarbejdere	S6
bevarer overblikket i hverdagen	L1
arbejde selvstændigt	K99
god til at samarbejde	S6
office-pakken	K02
har lyst til forandring udvikling	L1
bevare overblikket i stressede situationer	L1
forene basal sygepleje og højteknologi	L1
arbejde bevidst med faglige og personlige kompetencer	S3
handlekraftig	K99
påtage dig ansvar	L1
være i meget tæt kontakt med patienter og pårørende	S3
turde gøre en forskel	L1
blive udfordret på etiske overvejelser	L1
bidrage til udvikling af sygeplejen	L1
gå i front	K07
gå på akut kald	L1
samarbejde på tværs af et stort hospital	L1
telefonisk kundeservice og salg	L1
flair for it	S5
høj stress tærskel	K99
skarp i en dialog	L1
salgsminded	K99
tager ejerskab over dit arbejde	L1
vælger at se udfordringer/problemstillinger fra den mest positive vinkel	L1
energisk	K99
villig til at arbejde hårdt og målrettet	L1
vinder og konkurrence menneske	K99
etik	K99
kundeservice	K99
kvalitetsbevidst	K99
stabil	K99
kold og varm madlavning	L1
opfyldning af buffet	K99
køkken	K99
kantine	K99
hygiejnebevis	K99
fleksibel	K99
udadvendt	K99
præsentabel	K99
tager nye udfordringer med et godt humør	S6
lede og koordinere de mange forskellige vejledningsopgaver	L1
indskrivning	K99
fastholdelsessamtaler	K99
kurser	K99
samarbejde med lærere og administration	S3
telefon- og træffetid	L1
planlægning og evaluering af kursustilbud	L1
uddannelsessektoren	L1
samarbejds- og organisatoriske evner	L1
bevare overblikket	K99
godt humør	L1
varetage den kliniske uddannelse af sygeplejestuderende	L1
varetage den kliniske uddannelse af 4-6 sygeplejestuderende pr	L1
bedside-undervisning	S4
planlægge og afvikle individuelle kliniske uddannelsesforløb	S3
planlægge og gennemføre studiesamtaler	S3
vejlede og eksaminere ved interne prøver	L1
planlægge og gennemføre opfølgningsmøder	S3
fastholde og videreudvikle et lærings- og studiemiljø hvor refleksion vejledning og undervisning er i fokus	L1
informere og ajourføre afsnittet om udviklingen indenfor sygeplejerskeuddannelsen	L1
dansk autorisation som sygeplejerske	K99
pædagogisk efteruddannelse svarende til 1/6 diplom	S3
sygeplejerskeuddannelsen	K99
engagement og interesse indenfor det kliniske såvel som pædagogiske felt	A2
kliniske såvel som pædagogiske felt	A2
debitor- og kreditorstyring	K99
kontering og bogføring af bilag	S6
afstemning af kasse og bankkonti og øvrige mellemregningskonti	L1
Momsindberetning	K99
kontrol og frigivelse af lønbilag	L1
regnskabsmæssig forståelse	K99
navision stat	K99
statens lønsystem	K99
arbejder med kontaktpersonsfunktion	K99
arbejder jeg-støttende	L1
arbejde med mennesker med en psykisk sygdom	K99
arbejde i et tæt tværfagligt samarbejde	L1
arbejde selvstændigt	K99
træffe de nødvendige beslutninger	K99
bevist om sin måde at kommunikere på	S6
praksisnærhed	L1
faglighed	K99
videreudvikling	K99
kvalitetssikring	K99
undervise	S1
Erhvervsøkonomi	K99
salg og service	K10
Samfundsfag	K99
it	K07
undervise	S1
administration	K09
økonomi	K99
ha	K99
cand.merc	K04
undervise	S1
tysk	K99
engelsk	K99
dansk	K99
Samfundsfag	K99
ba	K06
uddannelses på kandidatniveau	L1
dygtig	K99
engageret	K99
har lyst til at undervise	S6
teamorienteret	K99
indstillet på tværfagligt samarbejde	L1
humor	S3
humanistisk livssyn	K99
udadvendt	K99
skabe relationer	K99
ser forandringer og udviklingsmuligheder som en udfordring	L1
helhedsorienteret	K99
pædagogikum	K99
værtskab	K99
service	K10
kontakt til vore mange gæster	S6
gøre en positiv forskel	L1
professionel servering	K99
a la carte	S6
selskab	K99
vejlede gæster i valg af menu og vine	S6
skabe resultater som kan ses og mærkes	L1
fagligt stolt	K99
sætter en ære i at vore gæster får de bedste personlige oplevelser	L1
sælgende	K99
kontaktskabende	K99
velsoigneret	K99
smilende	K99
god fysik	K03
bevare overblikket i stressede situationer	L1
samarbejde på tværs af afdelinger og faggrupper	L1
ser en fordel i at have et varieret arbejdsskema med skiftende arbejdstider	L1
anerkendende	K99
imødekommende	K99
indgå i et tværfagligt team	L1
direkte plejerelateret opgaver	S3
opvarmning og anretning af aftensmad	S6
arbejde med ældre borgere på midlertidigt ophold	K99
arbejde ud fra en helhedsorienteret vinkel	L1
samarbejder ud fra et anerkendende fokus	L1
bevare roen og overblikket	L1
smilende	K99
fleksible	K06
hjælpsomme	K99
smager på maden	knowledge
dyrke madglæden og de gode råvarer	K99
mellemstort køkken	K99
Helsingør	L1
positiv af sind	L1
hjælpsom	K99
finder løsninger selvom du er presset	L1
fleksibel	K99
ser mulighederne i et frit samarbejde	L1
bespise alle slags mennesker	K99
opfordrer børnene til at være hjælpsomme hensynsfulde og positive	S3
styrke gruppefællesskabet	K99
giver børnene mulighed for medbestemmelse	S6
alsidig	K99
aktiv	K99
positiv	K99
samarbejdsorienteret	K99
godt overblik	K99
skabe en tryg og udviklende dagligdag for børnene	L1
brænder for sit fag	L1
musik	K99
natur	K99
udeliv	K99
orientere sig	S6
arbejde med it som værktøj	L1
fagligt velfunderet	K99
reflektere over din praksis	L1
opstilling af regnskaber/årsregnskaber	S6
revision	K06
moms	K99
daglig kontering	L1
kommunikation og it	S5
informatik	K99
programmering	S5
medialogi	K99
tages højde for elevens selvstændighed og personlige udvikling	S4
undervisning og planlægning i et tæt teamsamarbejde	L1
cand.scient i informatik	K03
cand.mag i multimedier humanistisk informatik	K03
computerspilsbranchen	K99
PG/pædagogikum	K99
interaktive medier	K99
programmering	S5
gamification	K99
computerspilsudvikling	K99
skabe tillid og kontakt til unge mennesker	L1
naturlig autoritet	L1
let ved at sætte rammer for det faglige samvær med eleverne	S6
samarbejde med kollegerne	K99
kreativ	K99
innovativ	K99
respekt for menneskers forskelligheder	L1
påvirke andre på en positiv måde	L1
grafiske evner	K99
kvalitetssikring af grafisk materiale	K99
sammensætning af 360-billeder	S6
efterbehandling af corporate billeder	L1
billedredigering	K99
InDesign	S3
photoshop	K06
detaljeorienteret	K99
effektiv	K99
arbejder selvstændigt	K99
arbejdsmoral	K99
billedbehandling	K99
fagligt dygtig	K99
engageret	K99
arbejdsmarkedspolitik	K99
statistik	K99
samfundsøkonomi	K99
stud.polit	K03
stud.scient.oecon	K03
stud.ha	K99
stærk faglig profil	L1
fordyber dig i og tager ansvar for de opgaver du stilles overfor	S6
analytiske og metodiske færdigheder	L1
skriftlige formidlingsevner	L1
kvantitative analyser	S2
arbejde dybdegående med empiriske og statistiske analyser	S3
skabe grundlag for fremtidens politikudvikling	L1
kvantitative og statistiske evalueringer	S2
analyser med brug af individdata	S6
sas	K06
statistiske værktøjer	K09
behandling af store mængder data	S6
gåpåmod	K99
arbejde med empirisk metode	S3
koble resultaterne til den økonomiske teori	A2
”ole opfinder”	L1
svejse	K99
arbejde selvstændigt	K99
flair for teknik	S2
”regne den ud”	0000
udvikle / designe / samle / svejse en kabine	L1
pp tråds hånd svejser	knowledge
indgå i et samarbejde	L1
trykning af ekstrakter	S6
kopiere ankesagens dokumenter	L1
vedligeholdelse af tjenestekøretøjer	L1
opsætning af udstyr	L1
papir- og affaldshåndtering	K99
sikre kvalitet og effektivitet i vores sagsbehandling	S3
gode evner for samarbejde	L1
serviceminded	S1
robust	K07
engageret	K99
stabil	K99
ansvarsbevidst	K99
pligtopfyldende	K99
udfører dine opgaver med høj kvalitet	S3
situationsfornemmelse	K99
fleksibel	K99
overkomme fysiske arbejdsopgaver	K99
godt humør	L1
kørekort til personbil b	S6
afholde status	K03
plukkes	K99
pakkes	K99
fysik i orden	L1
fysisk arbejde	K99
går engageret til dine arbejdsopgaver	S6
stabil	K99
pligtopfyldende	K99
går op i detaljen	L1
effektiv	K99
engelsk	K99
ordenssans	K99
grundig i dine arbejdsopgaver	K99
god fysik	K03
fysisk arbejde	K99
sætter borgeren i centrum	L1
lære nyt	K99
humoristisk sans	L1
samarbejde	K99
lungemedicin	K99
varetage specialiserede og almene lungemedicinske opgaver	S3
videreudvikle området	K99
bidrage på visionærvis og aktivt til at udvikle specialet yderligere	L1
indgå engageret i både videreudvikling og drift af det lungemedicinske speciale	L1
understøtte en kultur hvor der lægges vægt på et godt og dynamisk arbejdsmiljø	L1
kommunikative egenskaber	K99
samarbejde tværfagligt	K99
bidrage aktivt til forskning uddannelse og kvalitetsudvikling	S4
gå aktivt ind i afdelingens kvalitetsarbejde	S6
optimering af patientforløb og patient- og pårørendeinvolvering	S3
jordemoderfaget	K99
konsultationsarbejde	K99
barselsklinik	K99
ammeklinik	K99
fleksibel	K99
hjælpe med at passe svangre- og barselspatienter	S3
hjælper hinanden på tværs af afsnittene	L1
klinisk sparring	K09
vejlede studerende	L1
deltage i projektarbejde	K99
stan certificeret	K99
jordemoderfaglig visionær	K99
pædagogiske empatiske og kommunikative evner	S5
Glad	K99
imødekommende	K99
initiativrig	K99
fleksibel	K99
omstillingparat	K99
arbejde med at udvikle samt forbedre klinisk praksis	L1
forsknings- og udviklingsarbejde	L1
patientsikkerhed	K99
patientinvolvering	K99
rationel drift	K07
rengøring	K99
tøjvask	K99
udviklingsorienteret	K99
planlægge en inklusionsårsplan	K99
være en del af skolens ressourcecenter/pædagogisk læringscenter	L1
samarbejde med lærere elever forældre ledelsen samt øvrige eksterne samarbejdspersoner	S3
godt funderet skriftligt og mundtligt	L1
inklusionsfremmende aktiviteter	S3
arbejde selvstændigt og tværfagligt	L1
sætte din viden i spil i forhold til kolleger med forskellige faglige baggrunde	S6
mangfoldighed	K99
fællesskaber	K99
inkluderende læringsmiljøer?	S3
inkluderende læringsmiljøer	K99
omsorg	K99
kontakt	K99
udvikling af børnenes muligheder for at deltage i læringsfællesskaber ( leg klasse- og læringsrummene frikvarter	A2
være en del af skolens ressourcecenter/pædagogisk læringscenter	L1
udvikler en observations- og sparringskultur	L1
støtte lærerne forældrene og eleverne i et struktureret og forudsigeligt læringsmiljø	L1
sparring med lærerne	S1
stimulering og udvikling af fællesskab sociale og personlige kompetencer hos eleverne	L1
understøtte enkelte eller grupper af elever	L1
social træning	A2
samarbejde tæt med en række af skolens lærere	L1
arbejde med retningslinjer for datamodellering	S6
datamodellering	K06
gøre en forskel	L1
udnytte værdien af store datamængder optimalt?	L1
tænker strategisk	K99
arbejde med model- og datastandarder	S6
arbejde i tæt samspil med it-arkitekter og udviklere	L1
designe og optimere løsninger på vores nye dataplatform	L1
designe og implementere værdiskabende datamodeller	S3
udforske analytiske muligheder	L1
rådgive og støtte organisationen i strategisk anvendelse af data	L1
implementere og vedligeholde governance	S4
definere metoder og processer for udvikling og drift	S6
udvikle og implementere strategi og roadmap	K04
designe og kommunikere standarder for datamodellering og metadataregistrering	S7
støtte og køre vores data governance-program	L1
igangsætte nødvendige initiativer i projekterne	L1
engagere dig i datakvalitetskontrolprocesser	L1
dokumentere og vedligeholde fysisk og logisk dataarkitektur	L1
understøtte daglige issues vedrørende datadokumentation	L1
etablere og vedligeholde reference- og løsningsarkitektur	L1
målbilleder	K99
guidelines	S4
principper	K99
udnytte data på nye måder	K06
arbejde dedikeret	L1
sikre effektiv udvikling af værdiskabende løsninger	L1
information/data	K06
processer	K99
dataintegrationer	K99
implementering af nye it-løsninger	S6
arbejde på et højt abstraktionsniveau	L1
designe og/eller omsætte tekniske beskrivelser og behov til tekniske og datamæssige løsninger	L1
samarbejde	K99
sikre den nødvendige koordinering og videndeling	S3
formidler	K99
holder hovedet koldt i pressede situationer	L1
arkitektur	K99
data	K06
ny teknologi	K99
mod på at lære nyt	K99
arbejde projektorienteret	K99
Datamodelleringskoncepter	K99
data vault	K06
Snowflake	K99
3	K06
datamodeller på bl.a	knowledge
xml	K06
CSV	K99
AVRO	K99
PARQUET	K99
Arkitekturrammeværk	K99
zachman framework	K06
Datamodelleringsværktøjer	K99
ea sparks	K06
Qualiware	K99
Datakvalitetskoncepter	K99
cloud-baseret it-arkitektur eller udvikling	L1
etl	knowledge
data lake	K06
metadata registrering og lineage	K05
design af løsninger i en offentlig kontekst	A2
fda	K99
OIO	K99
opbygning af data flows	S6
sikre beboerne en høj livskvalitet	L1
omstille dig til nye rutiner	L1
deltage i dækningen af vagter ved sygdom	L1
arbejde med plejen af ældre	L1
arbejde med at dokumentere	S6
KOS2	K99
betjene psykiatrisk center	K09
tjeneste	K99
udadvendt	K99
energi- og kraftværksområdet	K99
projektledelse af teknisk komplicerede og udfordrende energianlæg	L1
-biomassekonvertering af fossilfyrede kraftværker	K99
-optimering af kraftværker og anlæg	S3
-projektering af nye kraftværksanlæg	L1
-drift- og vedligeholdelse af anlæg	L1
task force indsats	S4
haverier	K99
due diligence projekter	S1
feasibility studier	K99
strategi indsatser	K99
arbejde tæt sammen med kunder	K99
opbygge gode relationer til netværk	S3
arbejde i et dynamisk miljø	L1
interesse for at udvikle dig	L1
energi	K99
kraftværker	K99
miljø	K09
energiområdet	K99
projektledelse	K99
energiområdet	K99
byggeri og anlæg	L1
strukturere projektets faser	L1
sikre effektiv projektafvikling	L1
projektering/projektledelse	K10
komplette projektforløb	K99
planlægning	S4
projektering af anlæg	L1
udbud samt tilsyn	L1
projekt- og byggeledelse	S6
kraftværker	K99
miljøanlæg	L1
kontekst- og forretningsforståelse	L1
arbejde systematisk	K99
arbejde i et internationalt miljø	L1
dansk	K99
engelsk	K99
frisk sælgende personlighed?	S3
kontakte virksomhedsledere og andre ansættende ledere i mindre og mellemstore virksomheder	L1
arbejder selvstændigt	K99
højt aktivitetsniveau	K99
salgsdialoger	K99
skaffe nye kunder i butikken	L1
god energi	K99
indstilling til at ville lykkes	S6
vindermentalitet	K99
motiveres af et ja tak	K08
ikke lader dig slå ud af et nej tak	L1
social	S1
skaber en god stemning	L1
New Bizz	K99
bagerfaget	K99
kvalificeret	K99
energisk	K99
reservedels indkøb håndtering udlevering og salg	L1
værkstedsplanlægning	K99
indskrivning	K99
skadekoordinering med eksternt pladeværksted	K99
telefonekspedition	K99
Engageret	K99
selvstændig	K99
ansvarlig	L1
serviceminded	S1
Dracar+	K99
Suzuki	K99
sælge produkter	A2
tillid	K99
loyalitet	K99
smil	K99
positiv energi	K99
samarbejde	K99
koordinering	K99
positiv indstilling til samarbejde problemløsning og tilgang til andre mennesker	S3
pet/ct	K02
spect	K99
fysiologi	K99
kombinere fysiologi med anatomi	A2
anatomi	K99
diagnostik	S3
stadieinddeling af sygdomme	K99
terapimonitorering	K99
matematiske begavelse	L1
visuelle betragtende hjerne	A2
behandling med radioaktive lægemidler	S3
visitation	K99
beskrivelser af forskellige typer undersøgelser	L1
fysiologisk og/eller medikamentel belastning af hjertet	L1
hjerteperfusionsundersøgelser	K99
klinisk fysiologi	K09
nuklearmedicin	K99
abcde principperne	K99
måle værdier	L1
måle crp hæmoglobin og leucocyter	L1
stixe urin	K99
tage dyrkninger	K99
sonde	K99
urin-kateter	K02
pvk	K99
CVK	K99
sc-nål	K05
hjerte lunge speciale	K10
forebygge indlæggelser	S3
sikre tæt samarbejde med relevante samarbejdspartnere	S3
skabe høj kvalitet i borgerens behandlingsforløb	L1
understøtte en ensartet og høj kvalitet på tværs af sektorer	L1
sektorovergange	K99
relationskompetencer	K99
faglig nysgerrighed	K99
varetagelse af sygeplejeopgaver	K99
håndtering af ustabile borgere	A2
arbejde løsningsorienteret	K99
arbejde selvstændigt	K99
tage beslutninger i pressede situationer	S6
fejlfinding på og reparation af produktionsmaskiner	L1
forebyggende vedligehold	K99
planlægning af større eftersyn	L1
tilsyn og planlægning af arbejdsopgaver for eksterne håndværkere	L1
optimering af produktionsudstyr	S3
projektarbejde	K99
teknisk profil	K06
el arbejde	K99
procesteknisk forståelse	L1
større rørinstallationer	K99
regulering af tryk og flow	S6
el-styringer	K99
industrigasser	K99
prioritere	K99
planlægge	K99
overblik	K99
arbejder struktureret og pligtopfyldende	L1
kommunikations- og samarbejdsevner	L1
positiv	K99
engageret	K99
arbejder selvstændigt og kvalitetsbevist	L1
fokus på overholdelse af deadlines	L1
bidrager til et højt sikkerhedsniveau	L1
godt humør	L1
søge og dele viden	L1
engelsk	K99
it	K07
inspirere	K99
udfordre	K99
rumme	K99
aktiv medspiller	K99
anerkende tilgang	L1
respekterer og gerne udfordrer kollegers idéer og pædagogiske arbejde	L1
ledelse	K99
personaleledelse	K99
samarbejde	K99
drive og videreudvikle et rigtig godt børnehus	L1
trivsel	K99
lede en integreret institution	K07
faglighed	K99
lytte	K99
reflektere	K99
omsætte visioner til handling	S6
lydhør	L1
inddrager kolleger	L1
træffe beslutninger	K99
gå forrest	K99
overblik	K99
rummer samtidig nærvær og de små detaljer	L1
arbejde videre med mange af de tiltag vi allerede har i gang	S6
inspirerer også til kommende tiltag	L1
synlig i huset	L1
trives med de forskellige aspekter jobbet byder på	S6
ledelsesopgaver	K99
dialogbaseret	K99
anerkendende	K99
videreformidle	K99
inspirere	K99
kommunikerer ligeværdigt imødekommende og med tydelighed	S3
it-systemer	K99
humor	S3
humør	K99
skabe det gode børneliv	K99
indgå i et mindre sjak	L1
vejen som arbejdsplads	K99
kloak	K99
fiber	K07
fjernvarme	K99
Håndmandsarbejde	K99
vejen som arbejdspalds	K99
fjernvarme	K99
kloak	K99
fiber	K07
dansk	K99
troværdigt og inspirerende sætte retning	S3
stå i spidsen	K99
skabe engagement og følgeskab	L1
skabe en stabil og autentisk forbindelse	S3
sætte dagsordenen	K99
være værdiskabende	K99
levere skarpt fagligt og strategisk med- og modspil	A2
matche kravene til ledelse af den faglige indsats forhandlinger håndtering af vanskelige sager	L1
lang videregående uddannelse	L1
juridisk kompetence	K99
robust	K07
gennemslagskraft	K99
direkte ledelse	A2
ledelse af ledere	L1
ledelse	K99
personalejura	K99
arbejdsmiljø	L1
kompetence- og organisationsudvikling	K07
tillidsfuldt og konstruktivt samarbejde	K99
integritet	K99
ordentlighed	K99
loyalitet	K99
sikre såvel kompetent ledelse udvikling og styring af egen afdeling som den tværgående strategiske udvikling af hele organisationen	L1
hr-området	K99
telefonkontakt internt og eksternt	L1
administration for caféerne	K10
behandle og bogføre diners eurocard og pbs	K99
kronisk medicinsk speciale	K09
