design and refine every touchpoint of the customer journey	S1
design and refine every touchpoint of the customer journey	S1
tackling new problems and perspectives	S1
designing tools materials and stimulating content	S1
drive internal strategy and innovation	S4
CX	A1
content output	A1
impact technology can have on customers	S4
deliver a meaningful member experience	S4
researching and defining opportunities	S4
conduct interviews	A1
bring customer experience to life	S4
creating content	A1
deliver clear and attractive design outcomes	S4
defining our product roadmap	S4
delivering the right products and services	S1
driven by purpose	A1
cx design methodologies	A1
user journey planning	S1
qualitative research methods	S4
eye for beautiful design	S1
passion for innovative solutions	A1
take sketches and paper prototypes through to high quality design output	S1
communicator	A1
articulate clearly and effectively	A1
working both independently	A1
leading on collaborative design discovery	A1
Keynote	A1
Figma	A1
illustrator	A1
google workspace	S1
work with business leads	S1
structure draft and negotiate agreements	S1
advise clients on the various legal risks business strategies and other issues	S4
commercial transactions	S1
business operations	A1
contract drafting	A1
negotiation	S1
advisory	A1
provide strategic business and legal advice	S4
develop a comprehensive long-term approach	S4
manage and resolve legal issues	S4
commercial transaction support	S1
LLB	A1
qualified lawyer in eu member state	S1
media	A1
publishing	A1
internet companies	A1
drafting and negotiating technology and content acquisition licensing and distribution agreements	S1
current media and digital platform landscape	S1
thrive in a fast-paced hard working environment	S4
complete projects in a timely fashion	S1
teach children	S1
applied behaviour analysis	S4
psychology	A1
natural enthusiasm and energy to work with children	S1
interpersonal and communication skills	A1
listen	A1
understand	A1
educate	A1
advise	A1
present	A1
work as part of a professional team	S1
taking direction from managers	S1
giving and receiving feedback	S1
complement teachers’ delivery of the national curriculum	S1
develop the skills and strategies of other support staff	S1
work collaboratively with teaching staff	S1
assist teachers	S1
management/preparation of resources	S4
encourage pupils	S1
provide support	A1
support the inclusion of the pupil	S1
implement changes instructed by the bcba	S4
interpret and analyse data	A1
provide constructive feedback	S1
improve the functioning of the programme	S1
maintain consistency	A1
data analysis	A1
liaise with bcbas	S1
communicating data to a bcba	S1
ensuring that the data files are up to date	S1
identify the need for prepare and maintain teaching materials resources and data sheets	S4
monitor progress	A1
reviewing acquisition data behaviour frequency maintenance and generalisation	S1
identify short-term targets	S1
provide 1:1 intensive teaching sessions	S1
aba	A1
provide 1:1 support	S1
principles of aba	S1
enable inclusion	A1
support the child to engage with others participate and generalise skills	S1
use behaviour management strategies	S1
contribute to a purposeful learning environment	A1
encourage the pupil to interact and work cooperatively	S1
understand and implement school child protection procedures	S4
comply with legal responsibilities	A1
provide 1:1 support using the principles of aba	S1
aba	A1
enable inclusion	A1
support the child to engage with others participate and generalise skills	S1
provide personal care	S1
teach independence using the principles of aba	S1
aba	A1
record progress data	A1
working with children with autism	S1
aba	A1
support a child to access the national curriculum using aba principles	S1
communicate in a polite and professional way	S1
communicate effectively	A1
provide a customer-oriented service	S1
QCF	A1
overseeing and managing a small consistent highly trained and motivated staff team	S1
delivering care and support	S1
delivering childcare	S4
focused on obtaining the best outcomes	S4
demonstrate good leadership	S4
organise and support staff	S1
deliver the best possible care	S1
making sure the manager is aware of any and all incidents	S4
supervise and mentor staff	S1
organise work patterns	S4
facilitate training	A1
involved in liaising	S1
access appropriate services	A1
promote professional good practice	A1
quality control monitoring	S4
social care and well-being act 2014	S1
regulation and inspection of social care act 2016	S4
ensuring the smooth running of your shift	S4
ensuring that high standards are maintained	S1
support residential care workers	S4
building a strong positive work ethic	A1
ensuring the home is physically safe	S1
assisting with health and safety responsibilities	S4
completion of corresponding records	S1
providing a good quality home environment	S4
creating and developing links between the community and the home	S1
enable children to participate fully in the life of the community	S1
assist in the completion of impact assessments	S4
matching documentation	A1
oversight of the placement of children and young people	S1
ensuring the assessed needs of young people in the home can be met	S1
administering a system for monitoring progress	S4
preparing or overseeing each individual placement plan	S1
reviewing such plans	S4
ensure children/young people are supported to achieve	S1
contribute effectively to each child's individual placement plan review	S1
supporting children/young people	S1
review process	A1
ensuring that there is a comprehensive plan in place	S1
assist when requested in the completion of the rota	S1
ensuring there are always staff available	A1
promote an open and supportive atmosphere	S4
identifying the training and development of staff	S1
meet the objectives	S4
induction supervision and appraisal of staff	S1
supportive	A1
offer constructive feedback to staff	S1
ensure that you keep and maintain accurate records	S1
managing and monitoring paperwork and records	S1
advising on best practice	S1
ensuring that services are delivered	S4
statement of purpose	A1
managing and operating budgets	S4
sourcing appropriate services	A1
support the childcare practices	S1
provide regular budgetary updates	S4
ensure children and staff are aware of all the procedures	S1
qcf level 3	S1
l5 in leadership and management in health and social care	S1
registration and inspection social care act 2016	S1
service requirements	A1
working in a care setting	S4
managing budgets	S4
taking part in an inspection	S4
reasoning numeracy literacy	A1
technology skills	A1
work as part of a team	S1
working closely with colleagues and other agencies	S1
solve problems	S1
work within the principles of the children’s act and social services and wellbeing act	S1
children’s act and social services and wellbeing act	S1
child protection issues and procedures	S1
manpower	A1
planning/development/skills mix	S1
develop and encourage professional growth in others	S4
budgetary requirement and management	S1
lead effectively	A1
leadership abilities	S1
organisation and leadership skills	S1
lead motivate and influence others	S1
interpersonal skills	S1
approachable	A1
honest	A1
reliable	A1
accountability	S1
be responsible for the work undertaken	S4
driving licence	S4
RGN	A1
RMN	A1
RNLD	A1
nmc pin	A1
NMC	A1
sen	A1
supporting sen pupils	S1
learning difficulties	S4
autism	A1
SEMH	A1
work in a variety of ages and abilities	S1
learn about the curriculum and teaching techniques	S1
sen	A1
asc	A1
supporting sen – asc & semh	A1
SEMH	A1
proactive	A1
committed	A1
enthusiastic	A1
supporting sen	S1
build strong and productive relationships	S4
motivated	A1
ambitious	A1
creative	A1
driven	A1
put a personal touch on the menu	S1
brunch trends	A1
american comfort food	A1
lead a small team	S1
kitchen's day to day operations	S1
stock control	A1
compliance	A1
gp control	A1
managing supervising and training your kitchen team	S1
ensure high standards of hygiene are maintained	S1
come up with different exciting and unique brunch and evening dishes	S4
demonstrate leadership	S4
menu planning	A1
coshh	A1
hse	A1
EHO	A1
food hygiene qualification	A1
mechanical background	A1
assembly	A1
workshop	A1
use hand tools	S1
work from drawings and works instructions	S4
follow health & safety guidelines	A1
show willingness to help out	S1
work ethic	A1
food service	A1
striving for the best	S1
deliver first class customer service	S1
delivering a professional service	S1
ensuring all guests are given a warm welcome	S4
displaying excellent product knowledge	S4
help guests make the best choices	S4
ensuring all guests are treated in a professional manner	S1
taking orders promptly	A1
answering queries	S1
ensuring all areas in the restaurant and bar are clean and tidy	S1
support the kitchen with food service	S1
ensure guests receive their food in a timely manner	S1
work on the bar	S1
creating coffees and hot drinks	S4
providing a professional bar service to guests	S1
moving large tray of vegetables	S4
manual handling tasks	S1
food preparation	A1
retail sales	S4
customer service	S1
winning attitude	S1
food preparation	A1
bread and cookie baking	S1
ensure food storage and preparation areas are maintained	S4
health & safety and audit standards	S1
comply with food code of practice	A1
till operator	S1
monitoring stock levels	S4
checking in deliveries	S4
complete daily and weekly cleaning schedules	S4
follow security & safety procedures	S4
maintain a safe working environment	S4
maintain high personal presentation	A1
work as a team member	A1
deliver a high standard of service	S1
serve and add value to customer needs	S4
ensure hygiene standards are met	A1
meet and greet guests	S1
deliver exceptional customer service	S1
using flt to move stock throughout warehouse	S1
loading/ unloading trailers	S1
use of hand scanners & pc’s	S1
physically fit	A1
time keeping	A1
hard working attitude	S1
english	A1
work as a team & alone	S1
flt counterbalance licence	A1
administration	A1
diary management	A1
typing of correspondence	S4
attending meetings	S4
sales support	A1
processing invoices	S1
producing sales quotations	A1
team player	A1
flexible	A1
assist	A1
it	A1
word	A1
excel	S1
outlook	A1
powerpoint	A1
communicator	A1
build and develop strong relationships	S4
english	A1
valid passport	A1
full driving license	A1
travel	A1
working in a small team	S4
enjoy a variety of tasks	S4
aptitude to hygiene	A1
produce brilliant creative copy	A1
adept at taking a strategic direction and bringing ideas to life through the written word	S1
defining the brand voice and developing it through use of language and tone	S1
detail-oriented	S1
meticulous	A1
uphold quality standards of style and grammar	S1
produce high-quality edited messaging and content	S1
manage your time effectively	S4
prioritize and manage multiple projects	S4
working collaboratively	S1
communicator	A1
contribute to the culture	A1
oral and written communication skills	A1
interpersonal skills	S1
interact with people at all levels	S4
copywriting skills	S1
confident yet sensitive interviewing skills	S4
sub editing	A1
proofing	A1
attention to detail	A1
manage own workload	S1
work to deadlines	S1
writing	A1
brand strategy	A1
brand campaigns	A1
pitches	A1
proposals	A1
social	A1
internal communication	A1
office	A1
g-suite	A1
InDesign	A1
illustrator	A1
Keynote	A1
marketing	A1
creative writing	A1
communications	A1
hard worker	A1
customer service	S1
communicate respectfully with clients and the public	S1
multi trades work	A1
rail	A1
full uk driving licence	S4
flexible	A1
carpentry	A1
bricklaying	A1
plastering	A1
concrete repairs	S1
paving	A1
painting	A1
replacing doors and windows	S1
cscs card	A1
certification of skilled trades	A1
tfl certificate	A1
ce ( class 1 ) licence	A1
cpc	A1
digital tachograph	S1
Tipper	A1
walking floor	A1
wtd's ( working time directive	S4
health & safety conscious	A1
flexible	A1
cpc driver qualification card	S1
digi-card	A1
licence - category c+e	S1
Tachos	A1
cscs card	A1
ppe	A1
CSCS	A1
providing a world class patient service	S1
liaising with the manager	S1
drive performance in the store	S4
leading and inspiring fellow staff	S4
ensuring the clinic runs successfully and efficiently	S4
providing patients with the best optical products	S1
dealing with any enquiries effectively	A1
fulfilling management duties	S1
store operations and dispensing duties	S4
business and marketing acumen	S1
deliver the best customer service journey	S4
running of the store	S4
reporting to management	A1
striving to meet targets	S1
driving performance and sales	S4
motivating and leading staff	S1
deliver exceptional patient care	A1
smooth running of the clinic	S4
managing fellow staff members	S4
communicating any ideas or concerns	A1
ensure the best performance and development	S1
challenging the team	S4
deliver the best service	S1
excel targets	A1
dispensing duties	A1
recommending frames lenses and contact lenses	S4
reception and admin work	S1
diary upkeep	A1
patient appointments	A1
recruitment	A1
upholding to nhs guidelines	A1
nhs guidelines	A1
maintaining presentation and visual aesthetics of the store	S1
promoting the business	S1
optical	A1
accountable for nominated clients	S4
maximise profits	A1
develop the business	S1
ocean import	S1
commercial mindset	A1
demonstrate & generate enthusiasm	S1
'can-do' attitude	A1
identify problems	S1
respond in a timely fashion	S1
demonstrate personal drive	S1
communicate effectively	A1
active listening	A1
smart	A1
enthusiastic	A1
web development	A1
html	A1
css	S1
less	A1
SCSS	A1
PostCSS	A1
angular	A1
react	A1
js	A1
java	A1
c#	A1
client-side compatibility	S1
performance considerations	A1
debug issues in a full stack environment	S4
sql	A1
team player	A1
engage with colleagues	S1
communication skills	A1
independently conduct the experimental work	S1
design execution and analysis of phosphoproteomics experiments	S1
phd degree	A1
mass spectrometry-based quantitative proteomics	S1
phosphoproteomics	A1
molecular biology	A1
vector construction	A1
protein synthesis in e	A1
post-translational modifications	S1
b	A1
english	A1
communication and collaborations skills	A1
independence	A1
paper and project writing	S1
designing existing transport construction maintenance processes	S4
work in a dynamic and international team?	S1
developing and illustrating processes and concepts	S1
transport installation and maintenance of wind turbines	S1
develop construction concepts	S1
ensure that market requirements and best practice is included	S4
drive new product development	A1
ensure full value chain perspective in new products	A1
optimize construction	A1
cost reduction	S1
quality improvements	S1
collection of improvement suggestions and best practice	S4
plan and ensure development of global construction work processes	S4
ensure that requirements from the operational business are included in the wind turbine & tools designs	S1
create new concepts for turbine installation	S4
optimize existing processes	S4
testing verifying at site	S1
production	A1
supply chain	A1
production	A1
installation	A1
maintenance	A1
B.Sc	A1
production mechanical electrical marine engineering	S1
lean	A1
value stream mapping	A1
process mapping ( production or development	S1
develop processes or concepts for larger components	S4
risk assessment tools	A1
PFMEA	A1
process mapping	A1
communication	A1
presentation skills	A1
english	A1
cooperating with colleagues	S1
proactive mindset	A1
keep an overview in stressed situations	S4
outgoing	A1
project management skills	A1
handle complex pricing calculations?	S1
communicate quantitative analyzes	A1
influence the sales of large-scale projects?	S1
supporting the electricity sales team	S4
pricing calculations competitor analysis	A1
benchmarks	S1
prepare pricing calculations and price-/cost analysis	S4
present the calculations	S4
prepare business cases and benchmarks	S4
support the sales strategies	S1
build and maintain a database of submitted offers/kpis	S1
analytical proactive and structured workstyle	S1
high-quality mindset	A1
numerate	A1
communicative skills	A1
interact with your commercial and technical colleagues	S1
working independently	A1
build relationships across the organization	S4
innovative	A1
solution-oriented	S1
masters degree	S1
finance	A1
economics	A1
pricing and complex analysis	S4
microsoft powerpoint	A1
excel	S1
visual basic	A1
pivot	A1
capex/opex business cases	A1
english	A1
danish	A1
swedish	A1
norwegian	A1
pig production	A1
feeding	A1
moving	A1
castration	A1
insemination	A1
monitoring the animals health	S4
driving license	A1
desire to work with pigs	S1
work closely with developers designers and marketers	S4
develop beautiful campaigns	S1
create outstanding experiences	S4
maintain our frontend stack	S4
contribute with beautifully crafted layouts	S4
scalable and modulable code	S1
developing and integrating great frontend experiences	S4
collaborate with a team of designers copywriters and marketers	S4
craft and deliver exceptional landing pages and experiences	S4
deliver maximum impact	A1
creative solutions and ideas	S4
solve challenges	A1
improve our overall website & campaign performance	S4
build and maintain a design system and development process	S1
markup	A1
javascript	A1
organize and maintain markup javascript and css	S1
css	S1
developing quality well-performing and scalable code	S1
javascript	A1
html	A1
css/sass	S1
git	A1
angular	A1
react	A1
typescript	A1
restful apis	A1
responsive design media queries	S1
adobe creative suite	S1
sketch	A1
invision	A1
wordpress/php	A1
scrum/agile	A1
general management and development of the employees	S1
budget and resource allocation	S4
ensuring timely and efficient project execution	S1
drive the development of technology	S1
master or phd degree	S1
chemical/biochemical engineering	S1
bio(chemistry	A1
food science	A1
project leadership	A1
interfaces between external/internal customers	S1
commercial insight	A1
production	A1
drive technological advances	S4
increase expertise level in the department	A1
lead and motivate people	S1
communication skills	A1
people management	A1
implementation of successfactors	S4
compensation and performance management	S1
optimize and manage existing reward and benefits programmes and processes	S4
support the business priorities	S4
ensure local compliance	S1
develop global frameworks policies and programmes	S4
manage hq reward programmes	S4
perform benchmarking	A1
market analysis	A1
drive the annual salary review	S1
benchmarking work for salary range setting	S4
advise and train managers and hr business partners	S1
support strong anchoring of rewards policies and programmes	S1
rewards in a global context	S4
delivering a broad range of reward initiatives	S4
masters degree	S1
business administration	S1
hr	A1
finance	A1
economics	A1
excel	S1
powerpoint	A1
working with numbers and data	S1
strong focus on details	A1
building relationship with your stakeholders	S4
engaging with colleagues	S1
english	A1
registered surgeon	A1
patient-centred	A1
inclusive	A1
provide your patients with a safe and effective course of treatment	S1
see it systems as an aid in your work	S1
good humoured	S1
loyal	A1
dedicated	A1
flexible	A1
engage people in the streets	S4
conveying knowledge	A1
Extroverted	A1
energetic	A1
excited about meeting new people	S1
enjoy interacting with many different characters	S1
result oriented	S1
work constructively towards reaching goals	S4
good at acquiring new skills	S1
continuously working on your own development	S1
english	A1
valid visa to work in denmark	S1
read and understand addresses and house numbers	S4
team work	S1
cooperation	A1
walk on stairs	S4
ride a bike	S1
acceptable criminal record	S1
read the latin alphabet	S1
motivated	A1
good structure	A1
follow a route	A1
register when a shipment is delivered	S4
work professionally with high quality	S1
reliable	A1
responsible	A1
trustworthy	A1
responsible	A1
conscientious	A1
work in all kinds of weather at night	S1
good colleague	S1
lead and implement an aligned strategy	S4
drive the digital supply chain community	S1
developing and implementing a digital supply chain strategy	S4
sharing best practice	S1
developing new initiatives	S4
identify digital supply chain initiatives	A1
collaborate with internal customers	S1
agile program management	A1
digital solutions	A1
ensure a continued support knowledge sharing across segments	S4
digital supply chain	A1
energetic	A1
willing	A1
find compromises between multiple and sometimes conflicting interests	S4
strategic mindset	A1
big picture thinking	A1
deep dive	A1
customer obsession	A1
deliver results	A1
ownership	A1
implementation	A1
digital savvy	A1
data analytics	A1
process transformation	A1
iot ( industrial automation	A1
e-commerce	A1
startups	A1
agile	A1
communication presentation and facilitation skills	A1
well-structured	S4
independent working style	S1
willingness to travel	A1
curious	A1
enjoy learning	A1
develop new ideas	S4
create value	A1
manage risk from the sale and purchase of power	S1
work both independently and collaboratively	S1
deliver team objectives	A1
coordinate tender responses	S4
participate in contract negotiations	S1
build and maintain good working relationships	S4
acquiring knowledge	A1
developing understanding	S4
support team activities	A1
business	A1
economics	A1
maths	A1
desire to learn and develop	S1
proactive	A1
commercially astute	A1
problem-solving attitude	A1
team player	A1
thrive in an international environment	S4
communicator	A1
english	A1
self-starter	S1
enjoy a fast-paced work environment	S4
market analysis	A1
communication and analytical skills	S1
insights creation and commenting	S4
creation/ optimization of ppt	S1
revising stimulus material for research projects	S4
analysis of quantitative data	S1
working with multiple data sources and combining them into relevant insights	S4
dialogue and follow-up with research vendors	S4
contribute to insights communication	S1
marketing	A1
marketing	A1
business	A1
cand.merc	S1
cand.negot	A1
cand.oecon	A1
marketing	A1
market research	A1
thinking visually	A1
communicate your ideas and messages	S4
ambitious	A1
goal oriented	S1
show engagement	A1
demonstrate positive thinking	S4
can-do attitude	S1
see great challenges in being tasked with tactical as well as strategic marketing problems	S4
business understanding	A1
strategic	A1
analytical	A1
communicative	A1
dive into the numbers	S4
analyze	A1
turn numbers into actionable insights	S4
ms office tools	A1
excel	S1
PPT	A1
SPSS	A1
structured working style	S1
take on task responsibilities	S4
contribute with ideas and input	S1
english	A1
picking and packing	S1
picking and packing orders with a hand scanner	S1
receiving and registering goods	S4
controlling returned goods	S4
palletizing and shipments	S4
perfectionists	A1
manual work	A1
precise	A1
goal oriented	S1
team players	S1
helpful	A1
show initiative	A1
transport	A1
logistics	A1
people management and development?	S1
motivate and set the direction	S1
ensuring the pace of production	S1
develop your team	S4
professional leadership	A1
set the direction	A1
coach and develop your team	S1
ensure that production runs in accordance with gmp	S1
gmp	A1
enabling your team to deliver in a timely and flawless manner	S1
run or participate in systematic problem solving	S1
science	A1
pharmaceutical production	A1
managing people	A1
management	A1
gaining trust and respect	S4
structured	A1
keep the overall view	S1
thrive in a busy and constantly changing working day	S4
prioritize	A1
communication and collaboration skills	A1
gmp	A1
lean	A1
work in a structured and targeted manner	S1
never compromise on quality	A1
ensure continuous improvements	S4
motivated	A1
ambitious	A1
reliable	A1
maintaining cell lines	S1
perform molecular biology techniques	A1
pcr restriction	A1
cloning reactions	S1
dna/rna and protein purification procedures	S1
setting up routine imaging and cell sorting experiments	S4
sample preparation	A1
assist with the overall maintenance of the lab	S1
administration of several databases	S4
plasmids	A1
cell lines	A1
mouse colony	A1
antibodies	A1
purchasing	A1
stocking	A1
participate in the research projects	S4
responsible for training and providing technical assistance	S4
tissue culture techniques	A1
cell sorting	A1
working independently and organized	S4
self-motivated	S1
interpersonal and communication skills	A1
danish	A1
english	A1
basic molecular biology	A1
mouse research	A1
increase the value of it systems	S4
maintain and develop effective relationships?	S1
working in a dynamic environment?	S1
support your colleagues	S1
computer equipment	A1
telephony	A1
application support	A1
familiarise yourself with your colleagues' situation	S1
use your service skills to assist them as efficiently as possible	S1
prioritise incoming requests	S4
tick each task off the list	S1
providing first-line support	S1
communicating with and informing users	S1
resolving technical it issues	S4
providing application support	S1
receiving recording and referring cases to the appropriate team	S4
accurately executing specified procedures	S4
co-operation	S1
communicator	A1
it support	A1
microsoft's systems	A1
itsm tools	S1
application support	A1
work independently	A1
seeing your duties through to the end	S1
take a structured approach to work	S1
prioritising your tasks and identifying those that are the most important	S1
thrive in an outgoing role	S4
communicate concisely and accurately	A1
providing the best possible service	S1
demonstrating persistence	S1
patience	A1
attentiveness	A1
enjoy working in a dynamic environment	S4
english	A1
security clearance	A1
drive development of the software product roadmap	S4
find innovative solutions	A1
stays on top of current trends	A1
develop long term plans	S4
embrace work load enthusiastically	S1
comfortable with a fast paced quickly changing work environment	S4
technical and business skills	S1
articulate the vision in the way others will understand	S4
project management	A1
b2b market	A1
ux	A1
development	A1
define value proposition customer segments and customer channels	S4
lead the product development process	S1
correctly brief the other departments	A1
challenge outcomes	A1
english	A1
czech	A1
product / project management	S1
ux development process	S1
user testing	S1
understanding the results	S4
communication skills	A1
passion for a change	S4
establish rapport	A1
bond with a business partner	A1
think outside the box	S1
clearly and professionally present information	A1
generation and development of new and existing business opportunities	S1
credible	A1
lead generation	A1
appointment setting	S1
proposal development and presentation	S4
manage the international sales	S4
international sales	A1
business development process	A1
building new business relationships	S4
building on existing success	S4
reporting to the head of sales	S4
build new major business opportunities	S4
sales canvassing	S1
develop implement and manage sales and relationships	S4
negotiate and close business	S1
exceed targets	A1
being in regular telephonic and face to face contact with clients	S4
generate leads	S1
market and client-research	S1
break into medium to large organisations	S1
manage and be part of all processes of a typical sales cycle	S4
monitor competitor activity and market dynamics	S1
recognise and recommend improvements to existing processes	S1
improve revenue performance	S4
inspiring	A1
persuasive	A1
convincing	A1
sales canvassing	S1
cold calling	S1
booking meetings on the phone	A1
outgoing	A1
javascript	A1
reactjs	A1
java	A1
javascript	A1
reactjs	A1
java	A1
solving business problems	S4
innovation and engineering practices	S1
apply your depth of knowledge and expertise	S1
software development lifecycle	S1
partner continuously with your many stakeholders	S4
stay focused on common goals	S4
motivated	A1
deliver of a next-generation analytics products	A1
bs/ba degree	S1
application data and infrastructure architecture disciplines	S1
architecture	A1
design	A1
developmental toolsets	S1
industry-wide technology strategies and best practices	S1
work in large collaborative teams	S4
achieve organizational goals	A1
building an innovative culture	A1
java	A1
javascript	A1
business analysis	A1
development	A1
maintenance	A1
software improvement	A1
html5	A1
javascript	A1
developing multithreaded scalable concurrent applications	S1
node js ( server side and tooling	S1
react	A1
java	A1
spring	A1
java-ee	S1
java	A1
spring	A1
java-ee	S1
solving business problems	S4
innovation and engineering practices	S1
apply your depth of knowledge and expertise	S1
software development lifecycle	S1
partner continuously with your many stakeholders	S4
stay focused on common goals	S4
bs/ba degree	S1
java	A1
spring boot	A1
nosql	A1
message	A1
cloud	A1
ci/cd	S1
application data and infrastructure architecture disciplines	S1
architecture	A1
design	A1
developmental toolsets	S1
industry-wide technology trends and best practices	S1
work in large collaborative teams	S4
achieve organizational goals	A1
building an innovative culture	A1
modern programming languages	A1
business analysis	A1
development	A1
maintenance	A1
software improvement	A1
financial technology	A1
saas	S1
wealthtech	A1
azure	A1
.net	A1
asp.net-web-api	A1
powershell	A1
json.net	A1
financial technology	A1
saas	S1
wealthtech	A1
azure	A1
.net	A1
asp.net-web-api	A1
powershell	A1
json.net	A1
open for continuous change	A1
automation	A1
azure paas	A1
microservices	A1
.net	A1
powershell	A1
ms sql	A1
ci	A1
azure paas	A1
enhance and maintain ci infrastructure pipelines and azure paas environments	S1
ensure on-going health and stability of pipelines across multiple environments	S4
azure	A1
administrate and manage azure resources	S1
subscriptions	A1
resource groups	A1
devops	A1
GitHub	A1
support developers	A1
troubleshooting deployed applications	S1
identify app issues vs configuration/environment issues	S4
enhance quality through pipelines	S4
usage of static analysis tools	A1
SonarQube	A1
.net analyzers	A1
infer#	A1
creating and maintaining build and deployment pipelines for web applications and services	S1
azure appservice	S1
iis	A1
sql dbs	S1
azure appservice	S1
troubleshoot azure appservice hosted websites and services	S1
identify app issues vs configuration/environment issues	S4
.net	A1
automation	A1
powershell	A1
azure cli	A1
json	A1
yaml	A1
based templates	A1
AppServices	A1
redis	A1
ServiceBus	A1
api management	S1
CosmosDB	A1
KeyVault	A1
azure sql	A1
sql scripts	S1
azure devops ( cloud and server	S1
docker containers	S4
K8s	A1
english	A1
financial services	A1
java	A1
reactjs	A1
web-services	S1
financial services	A1
java	A1
reactjs	A1
web-services	S1
solving business problems	S4
innovation & engineering practices	S1
apply your depth of knowledge and expertise	S1
software development lifecycle	S1
partner continuously with your many stakeholders	S4
stay focused on common goals	S4
bs/ba degree	S1
application data and infrastructure architecture	S1
architecture	A1
design	A1
software systems	A1
developmental toolsets	S1
industry wide technology strategies and best practices	S4
work in a co-located team	S4
achieve organizational goals	A1
building an innovative culture	A1
software skills	A1
business analysis	A1
development	A1
maintenance	A1
software improvement	A1
deliver high quality products	A1
java/j2ee	S1
python	A1
go	A1
react	A1
cloud technologies	A1
AWS	A1
containers	A1
Kubernetes	A1
devops for platforms	A1
automated testing	A1
resource management	A1
artificial intelligence	A1
computer graphics	A1
software development	A1
python	A1
artificial intelligence	A1
computer graphics	A1
software development	A1
python	A1
build highly efficient accurate and scalable computer vision and machine learning services	S1
computer science	A1
solve technical challenges independently	A1
python	A1
english	A1
good communicator	A1
enjoy working in a team	S1
postgresql	A1
Django	A1
PostGIS	A1
opencv	A1
NumPy	A1
shapely	A1
pyhon multithreading and multiprocessing	S1
aws/azure	S1
computer vision	A1
machine learning	A1
e-commerce	A1
open-source	S1
ruby-on-rails	A1
sql	A1
heroku	A1
e-commerce	A1
open-source	S1
ruby-on-rails	A1
sql	A1
heroku	A1
gather technical requirements	A1
architect solutions	A1
estimate timelines	S4
deliver and further develop applications	S4
communicate	A1
investigate	A1
celebrate	A1
reward	A1
promote	A1
TDD	A1
agile delivery	A1
teamwork	A1
automated testing	A1
code reviews	A1
pair programming	S1
qa	A1
pm support	A1
staying in touch	S1
ruby on rails	A1
TDD	A1
deploy apps	A1
Heroku	A1
AWS	A1
sql	A1
english	A1
agile/scrum	A1
working with 3rd party api’s	S1
performed code reviews	A1
Docker	A1
spree commerce	A1
leading a team	A1
contributions to open source projects	S1
e-commerce	A1
ElasticSearch	A1
Kubernetes	A1
financial services	A1
reactjs	A1
cloud	A1
python	A1
financial services	A1
reactjs	A1
cloud	A1
python	A1
deliver initiatives	A1
modernizing and transforming the platform	S1
work on a mix of front-end back-end and cloud technologies	S1
running with a full stack development	S4
java	A1
python	A1
react js	A1
Redux	A1
public and private cloud offerings	S1
data warehousing/etl	S1
fixed income instruments	S1
reference data	A1
django	A1
postgresql	A1
redis	A1
django	A1
postgresql	A1
redis	A1
build software	S1
help our customers	S4
build and expand our predictive analytics platform	S4
work with a tightly knit team	S4
enterprise resource planning ( erp	S1
point-of-sales ( pos	S1
identify problems	S1
run experiments	A1
deploy promising solutions to production	S1
develop interfaces to erp and pos software providers	S1
etl	A1
work on etl pipelines	S4
integrate our customers data bases	S4
work closely together with our machine learning	S1
effective communication	S1
documentation	A1
writing software with emphasis on quality testability and automation	S1
backend development	A1
python	A1
linux administration	A1
Docker	A1
ansible	A1
git	A1
Pandas	A1
Celery	A1
django channels	A1
django rest framework	A1
redis	A1
Nginx	A1
gitlab ci	A1
postgresql	A1
english on level c1	A1
honest	A1
trustworthy	A1
communicates openly	A1
Cybersecurity	A1
data & analytics	A1
digital marketing	A1
powerbi	A1
dax	A1
cloud	A1
data-modeling	S1
azure-analysis-services	S1
Cybersecurity	A1
data & analytics	A1
digital marketing	A1
powerbi	A1
dax	A1
cloud	A1
data-modeling	S1
azure-analysis-services	S1
building front-end layer	S1
design and build front-end / bi layer	S1
power bi reports	A1
dax queries	A1
azure analysis services models	S4
troubleshoot issues	S1
recommend optimizations	S4
tune solution / reports for better performance	S4
scrum meetings	A1
sprint planning	A1
code reviews	A1
power bi	A1
DAX	A1
data modeling	A1
cloud	A1
CICD	A1
devops	A1
agile	A1
english	A1
bachelor's degree	S1
azure analysis services	A1
agile software development	A1
financial technology	A1
agile	A1
architecture	A1
agile software development	A1
financial technology	A1
agile	A1
architecture	A1
making the right decisions	S4
definition & communication of “fit for purpose”	A1
describing a solution architecture	S1
aligning the teams around the technical orientation	S4
connects with the teams	S1
evaluate the different technical alternatives	S1
continuous exploration and innovation	S1
delivery to business ( d2b	S1
service to deliver ( s2d	A1
work in delivery to business ( d2b ) or service to deliver ( s2d ) context	S1
creating business enabler art epics	A1
software/system design and architecture	S1
design	A1
modelling	A1
documentation	A1
solution architecture	A1
programming languages	A1
analyzing strategic objectives	S4
defining specific goals	S1
it or engineering bachelor / master degree	S1
scaled agile ( safe	A1
analytical and problem-solving skills	S1
networking	A1
communication	A1
persuasion	A1
ability to persuade others	S1
build and maintain positive and trustworthy relationships	S4
share knowledge	S4
engage in discussions and group decision-making	S4
presentation skills	A1
assertive	A1
pro-active	A1
personal efficiency	A1
financial technology	A1
c#	A1
f#	A1
typescript	A1
financial technology	A1
c#	A1
f#	A1
typescript	A1
modern workflows and tooling	S4
maintain quality	A1
work with aws infrastructure	S1
producing cloud native software	S1
continuous integration	A1
automated testing	A1
domain modelling	A1
ubiquitous language	A1
logging	A1
serverless containerisation	A1
dev/prod environment parity	S1
experimentation	A1
c#	A1
f#	A1
typescript	A1
serverless framework	A1
functional programming	A1
Cypress	A1
Jest	A1
Nunit	A1
SpecFlow	A1
Expecto	A1
FsCheck	A1
canopy	A1
functions as a service	A1
hosting	A1
messaging	A1
relational and non-relational databases	S1
Loggly	A1
c#	A1
f#	A1
typescript	A1
problem solver	A1
curious about new technology	S1
functional programming	A1
12-factor app approach	S1
build cloud	A1
takes ownership	A1
learn as much as possible	A1
good listener	A1
able to explain concepts	S4
committed to improving yourself	A1
demonstrate interest in technologies that are beyond the scope of your daily workflow	S1
lazy	A1
don't like boring repetitive tasks	S1
outsource your labour to the compiler	S1
applying yourself to learning	S1
pragmatist	A1
qa	A1
testing	A1
cypress	A1
mocha.js	A1
chai	A1
qa	A1
testing	A1
cypress	A1
mocha.js	A1
chai	A1
introduce and implement the newest standards and testing solutions/automation	S1
product creation	A1
build and provide access to test environments and new features	S1
responsible for a successful product launch	S4
bring expert knowledge	A1
define testing standards and strategies	S4
create detailed comprehensive and well-structured test plans and test cases	S4
design develop and execute automatic tests	S1
conduct exploratory/manual tests	S1
identify record document thoroughly and track bugs	S4
work closely with the product team	S1
make new features testable	S4
improve tickets	S1
update product information	A1
facilitate test environments access	A1
quality assurance	A1
software qa methodologies tools and processes	S1
automated testing tools	A1
Cypress	A1
pytest	A1
truffle	A1
solidity	A1
coding/scripting	S1
devops	A1
build test environments	A1
CircleCI	A1
Docker	A1
work in an agile & energetic startup environment	S4
english	A1
collaboration tools	A1
computer software	A1
open-source	S1
testing	A1
qa	A1
automation	A1
software-quality	A1
automated-tests	S1
collaboration tools	A1
computer software	A1
open-source	S1
testing	A1
qa	A1
automation	A1
software-quality	A1
automated-tests	S1
ensuring high quality for customer-specific software projects	S1
analysis and risk assessment	S4
creation maintenance execution and documentation of ( automated ) tests	S1
collaboration in project teams	A1
communication with technical customer departments	S4
active support of our development and operations teams	S4
creation analysis and processing of error reports	S4
computer science	A1
agile approaches to software testing and development	S1
tools procedures and programming languages for test automation	S1
familiarize yourself with new technologies	S4
contribute innovations	A1
handling and understanding of web-based applications apis	S1
good eye for details user expectations and potential sources of error	S1
structured and result-oriented way of working	S4
willingness to learn	A1
joy of communication	A1
independent cooperation	A1
team skills	A1
social competence	S1
german	A1
english	A1
financial services	A1
financial services	A1
solving business problems	S4
innovation and engineering practices	S1
apply your depth of knowledge and expertise	S1
partner continuously with your many stakeholders	S4
stay focused on common goals	S4
bs/ba degree	S1
application	A1
data	A1
infrastructure architecture disciplines	S1
architecture and design	S1
programming languages	A1
industry-wide technology trends and best practices	S1
financial control	A1
budget management	A1
work in large collaborative teams	S4
achieve organizational goals	A1
building an innovative culture	A1
r	A1
java	A1
nosql	A1
r	A1
java	A1
nosql	A1
solving business problems	S4
innovation & engineering practices	S1
apply your depth of knowledge and expertise	S1
partner continuously with your many stakeholders	S4
focused on common goals	A1
energetic	A1
intelligent	A1
self-starter	S1
java	A1
rest/web services	A1
r	A1
pentaho	A1
oracle	A1
nosql	A1
agile	A1
application process management	S1
monitoring platforms	S4
streamlining integration	S1
issue tracking	A1
deployment	A1
change management	S1
communicate advanced technical design and solutions	S4
work collaboratively in teams	S4
develop meaningful relationships	S1
achieve common goals	A1
application data and infrastructure architecture & design disciplines	S1
analyse requirements	A1
interact directly with business users	S1
cloud micro-service and container deployment patterns	S4
testing	A1
ci	A1
behaviour driven development skills	S1
work in large collaborative teams	S4
achieve organizational goals	A1
building an innovative culture	A1
java	A1
r	A1
databases	A1
etl tools	A1
r	A1
python	A1
machine learning	A1
data tables	A1
Qpid/MQ/Kafka/RabbitMQ	S1
big	A1
financial performance calculations	S4
calculating benchmark blends	S4
entertainment	A1
gaming	A1
mobile game	A1
unity3d	A1
c#	A1
user-experience	S1
entertainment	A1
gaming	A1
mobile game	A1
unity3d	A1
c#	A1
user-experience	S1
flair for gameplay	S1
aesthetic know-how?	S1
work closely with other programmers designers and artists	S4
implementing and maintaining various platforms and systems	S1
unity	A1
mobile game development	A1
unity3d	A1
c#	A1
unity	A1
implement new game features	S1
making the designs look final and pretty	S1
self-driven	A1
open-minded	S1
not afraid to be critical	S1
collaborate with your colleagues	S1
find solutions	A1
implementing new gameplay features and user interfaces	S1
contributing to and maintaining existing game features	S1
participating in the development of new features and optimizing existing ones	S4
participating in the development of performant and rigid systems	S1
running tests on new code	S1
mobile games	A1
unity3d ( ios and/or android	S1
c#	A1
ux	A1
making user experiences at an interactive degree	S1
3d game programming	S1
math	A1
dynamic skills	A1
aesthetic know-how	S1
system and architectural thinking	S4
developing mobile games with a large amount of content delivery	S1
sense of f2p game design	S1
tdd ( test driven development	A1
objective c	A1
java	A1
computer software	A1
databases	A1
information technology	A1
java	A1
algorithm	A1
database	A1
multithreading	A1
concurrency	A1
computer software	A1
databases	A1
