bredtorienteret	K99
varetage opbygning og drift af servicefunktioner	S4
indgå i et team	S1
alsidig	K99
renovering- og restaureringsopgaver	S4
Reperationsarbejder	K99
Flisearbejder	K99
Tagarbejder	S4
imuring af rygninge og grater	S3
fagudlært murer	K07
brænde for dit fag	S1
arbejde selvstændigt	A1
kundemindet	K99
arbejde sammen på tværs af faggrænser	S1
kørekort b og gerne be	K07
ledelseserfaring	S4
kvik	K06
arbejde selvstændigt	A1
kan lide at have travlt	S6
min tid	K01
arbejde med komplicerede patientforløb	S1
omsorg	K06
kol-team	S4
diabetes mellitus	K09
kol	K07
niv ( non invasiv ventilation	K07
lomholt-system	K05
clinical suite	K09
engageret	S4
korrespondance	S4
post	K06
arkivering	K06
bogføring	K08
regnskabsmæssige opgaver	K04
personalerelaterede opgaver	S4
administrativt sagsarbejde	S4
indkøb af kontorartikler	S4
vedligeholdelse af intranet og hjemmeside	S4
kontoruddannet	K99
it	K07
bogføring	K08
arbejdet i en kommune	S1
åben	S8
udadvendt	K99
bevare overblikket og begge ben på jorden	S2
velformuleret	K99
omstillingsparat	K99
fleksibel	A1
godt humør	S6
opus	K06
skrivning af notater i opus fra mirsk	S1
MIRSK	K99
opus	K06
ris	K09
LABKA	K99
indkaldelse af patienter	S3
finde journaler frem til ugeprogram	S4
oplæring af elever	S1
Officepakken	K99
GSÅben	K99
opus notat	K06
epikrise	K99
MIRSK	K99
orbit	K05
Labka	K99
ris	K09
godt humør	S6
kan lide at have travlt	S6
robust	K07
arbejde i et team	S1
en 473/	K99
endoskopi	K99
Olympus Iplex	K99
selvstændigt	S4
rejsevant	K99
bidrage til fremtidig udvikling?	S4
dygtigste	K99
effektive	S1
strukturerede	S5
herlig men stærk og udadvendt kommunikerende personlighed	S1
godt humør	S6
let til smil	S6
går altid foran med dit eksempel	S2
høj stresstærskel	K07
have mangebolde i luften	S8
initiativrig	S2
løsningsorienteret	A1
effektiv	A1
bevare overblikket	S3
struktureret	S5
trives i travl omskiftelig hverdag	S1
lagererfaring	K08
rengøringsartikler	K10
ledererfaring	S4
klar til en stor udfordring	S3
jernvilje	K99
personligt drive	S4
få styr på lageret	S4
deltager aktivt i den daglige drift	S4
varemodtagelse	K99
pluk og pak	S6
forsendelse	K08
rengøring i butik ,slagter og bager	S6
stabil	K07
grundig	K99
Kvalitetsbevist	K99
Serviceminded	A1
arbejde selvstændig og i team	S1
dansk	L1
øge kvaliteten	S4
sænke omkostningsniveauet	S2
ledererfaring	S4
økonomi	K03
it og statistik	K05
løn- og personaleadministration	K04
realisere visionen	S4
sikre en stærk ledelse af myndighedsopgaverne	S4
varetage dialogen	K06
løn og personale	K04
regnskab	K04
ledelsesinformation	K04
it	K07
strategisk sans	S4
ledererfaring	S4
akademisk uddannelse	K01
lederuddannelse	K01
forretningsforståelse	S4
levere stærke strategiske bud	S4
udadvendte facon	K06
personlige pondus	S4
skabe gode relationer til samarbejdspartnere	S1
fastholde en naturlig gennemslagskraft	S4
skabe et inspirerende arbejdsmiljø	S4
motivere dine medarbejdere	S4
levere synlige resultater	S1
dygtig	S1
engageret	S4
frisk	K05
engageret	S4
udadvendt	K99
godt humør	S6
klar til at lære nyt	S1
arbejde med computer	S5
servicere vores web-butik	S3
service og kvalitets orienteret?	K04
serviceminded	S1
selvstændig	S4
ansvarsbevidst	S4
Diners	K99
Eurocard	K99
Fakturere	K99
fakturere samt følge op på debitorer	S2
bogføre indbetalinger	K08
have overblik over de forskellige konti for caféerne	S4
videreudvikling at rutiner og systemer	S4
regnskab	K04
administration	K09
giver venlig service overfor vores leverandrøre medarbejdere	S4
bevarer overblikket i hverdagen	S4
arbejde selvstændigt	A1
god til at samarbejde	S1
office-pakken	K07
har lyst til forandring udvikling	S2
bevare overblikket i stressede situationer	A1
forene basal sygepleje og højteknologi	K09
arbejde bevidst med faglige og personlige kompetencer	S2
handlekraftig	S4
påtage dig ansvar	A1
være i meget tæt kontakt med patienter og pårørende	S1
turde gøre en forskel	A1
blive udfordret på etiske overvejelser	S1
bidrage til udvikling af sygeplejen	S4
gå i front	A1
gå på akut kald	S6
samarbejde på tværs af et stort hospital	S1
telefonisk kundeservice og salg	K04
flair for it	S2
høj stress tærskel	K10
skarp i en dialog	S1
salgsminded	K04
tager ejerskab over dit arbejde	S4
vælger at se udfordringer/problemstillinger fra den mest positive vinkel	S1
energisk	S3
villig til at arbejde hårdt og målrettet	S1
vinder og konkurrence menneske	S4
etik	S1
kundeservice	K04
kvalitetsbevidst	A1
stabil	K07
kold og varm madlavning	K07
opfyldning af buffet	S3
køkken	K07
kantine	K99
hygiejnebevis	K99
fleksibel	A1
udadvendt	K99
præsentabel	K99
tager nye udfordringer med et godt humør	S3
lede og koordinere de mange forskellige vejledningsopgaver	S4
indskrivning	K02
fastholdelsessamtaler	K09
kurser	K01
samarbejde med lærere og administration	S1
telefon- og træffetid	K04
planlægning og evaluering af kursustilbud	S4
uddannelsessektoren	K04
samarbejds- og organisatoriske evner	S1
bevare overblikket	S3
godt humør	S6
varetage den kliniske uddannelse af sygeplejestuderende	S4
varetage den kliniske uddannelse af 4-6 sygeplejestuderende pr	S1
bedside-undervisning	K01
planlægge og afvikle individuelle kliniske uddannelsesforløb	S4
planlægge og gennemføre studiesamtaler	S4
vejlede og eksaminere ved interne prøver	S3
planlægge og gennemføre opfølgningsmøder	S1
fastholde og videreudvikle et lærings- og studiemiljø hvor refleksion vejledning og undervisning er i fokus	S4
informere og ajourføre afsnittet om udviklingen indenfor sygeplejerskeuddannelsen	S4
dansk autorisation som sygeplejerske	K10
pædagogisk efteruddannelse svarende til 1/6 diplom	K01
sygeplejerskeuddannelsen	K01
engagement og interesse indenfor det kliniske såvel som pædagogiske felt	S1
kliniske såvel som pædagogiske felt	K09
debitor- og kreditorstyring	K10
kontering og bogføring af bilag	K04
afstemning af kasse og bankkonti og øvrige mellemregningskonti	S2
Momsindberetning	K04
kontrol og frigivelse af lønbilag	S4
regnskabsmæssig forståelse	K04
navision stat	K06
statens lønsystem	K06
arbejder med kontaktpersonsfunktion	S1
arbejder jeg-støttende	S1
arbejde med mennesker med en psykisk sygdom	S3
arbejde i et tæt tværfagligt samarbejde	S1
arbejde selvstændigt	A1
træffe de nødvendige beslutninger	S4
bevist om sin måde at kommunikere på	S1
praksisnærhed	K04
faglighed	S1
videreudvikling	K06
kvalitetssikring	K04
undervise	S1
Erhvervsøkonomi	K04
salg og service	K04
Samfundsfag	K99
it	K07
undervise	S1
administration	K09
økonomi	K03
ha	K06
cand.merc	K04
undervise	S1
tysk	L1
engelsk	L1
dansk	L1
Samfundsfag	K99
ba	K06
uddannelses på kandidatniveau	K01
dygtig	S1
engageret	S4
har lyst til at undervise	S1
teamorienteret	S4
indstillet på tværfagligt samarbejde	S1
humor	S1
humanistisk livssyn	K01
udadvendt	K99
skabe relationer	S1
ser forandringer og udviklingsmuligheder som en udfordring	A1
helhedsorienteret	S1
pædagogikum	K01
værtskab	K99
service	S3
kontakt til vore mange gæster	S3
gøre en positiv forskel	S1
professionel servering	K02
a la carte	K06
selskab	K10
vejlede gæster i valg af menu og vine	S3
skabe resultater som kan ses og mærkes	S1
fagligt stolt	S4
sætter en ære i at vore gæster får de bedste personlige oplevelser	S1
sælgende	S1
kontaktskabende	S1
velsoigneret	K99
smilende	K99
god fysik	K07
bevare overblikket i stressede situationer	A1
samarbejde på tværs af afdelinger og faggrupper	S1
ser en fordel i at have et varieret arbejdsskema med skiftende arbejdstider	S4
anerkendende	S1
imødekommende	A1
indgå i et tværfagligt team	S1
direkte plejerelateret opgaver	K10
opvarmning og anretning af aftensmad	S3
arbejde med ældre borgere på midlertidigt ophold	S3
arbejde ud fra en helhedsorienteret vinkel	S1
samarbejder ud fra et anerkendende fokus	S1
bevare roen og overblikket	S2
smilende	K99
fleksible	A1
hjælpsomme	K99
smager på maden	S6
dyrke madglæden og de gode råvarer	S4
mellemstort køkken	K07
Helsingør	K99
positiv af sind	S1
hjælpsom	S6
finder løsninger selvom du er presset	S1
fleksibel	A1
ser mulighederne i et frit samarbejde	S1
bespise alle slags mennesker	S3
opfordrer børnene til at være hjælpsomme hensynsfulde og positive	S1
styrke gruppefællesskabet	S4
giver børnene mulighed for medbestemmelse	S4
alsidig	K99
aktiv	S1
positiv	S1
samarbejdsorienteret	S1
godt overblik	S3
skabe en tryg og udviklende dagligdag for børnene	S4
brænder for sit fag	S1
musik	K02
natur	K05
udeliv	K99
orientere sig	S4
arbejde med it som værktøj	S6
fagligt velfunderet	S1
reflektere over din praksis	S1
opstilling af regnskaber/årsregnskaber	S4
revision	K06
moms	S6
daglig kontering	K10
kommunikation og it	K06
informatik	K06
programmering	K06
medialogi	K01
tages højde for elevens selvstændighed og personlige udvikling	S1
undervisning og planlægning i et tæt teamsamarbejde	S1
cand.scient i informatik	K03
cand.mag i multimedier humanistisk informatik	K06
computerspilsbranchen	K02
PG/pædagogikum	K99
interaktive medier	K02
programmering	K06
gamification	K99
computerspilsudvikling	K06
skabe tillid og kontakt til unge mennesker	S1
naturlig autoritet	K04
let ved at sætte rammer for det faglige samvær med eleverne	S4
samarbejde med kollegerne	S1
kreativ	S1
innovativ	S1
respekt for menneskers forskelligheder	S1
påvirke andre på en positiv måde	S1
grafiske evner	S1
kvalitetssikring af grafisk materiale	K07
sammensætning af 360-billeder	S3
efterbehandling af corporate billeder	K02
billedredigering	K02
InDesign	K99
photoshop	K06
detaljeorienteret	S1
effektiv	A1
arbejder selvstændigt	A1
arbejdsmoral	S4
billedbehandling	K02
fagligt dygtig	S1
engageret	S4
arbejdsmarkedspolitik	K04
statistik	K05
samfundsøkonomi	K03
stud.polit	K03
stud.scient.oecon	K03
stud.ha	S1
stærk faglig profil	S4
fordyber dig i og tager ansvar for de opgaver du stilles overfor	A1
analytiske og metodiske færdigheder	S2
skriftlige formidlingsevner	S1
kvantitative analyser	K04
arbejde dybdegående med empiriske og statistiske analyser	S2
skabe grundlag for fremtidens politikudvikling	S4
kvantitative og statistiske evalueringer	K03
analyser med brug af individdata	S5
sas	K06
statistiske værktøjer	K05
behandling af store mængder data	S2
gåpåmod	K99
arbejde med empirisk metode	S1
koble resultaterne til den økonomiske teori	S1
”ole opfinder”	K06
svejse	K06
arbejde selvstændigt	A1
flair for teknik	S2
”regne den ud”	S6
udvikle / designe / samle / svejse en kabine	S1
pp tråds hånd svejser	K06
indgå i et samarbejde	S1
trykning af ekstrakter	K07
kopiere ankesagens dokumenter	S2
vedligeholdelse af tjenestekøretøjer	S4
opsætning af udstyr	S8
papir- og affaldshåndtering	K07
sikre kvalitet og effektivitet i vores sagsbehandling	S2
gode evner for samarbejde	S1
serviceminded	S1
robust	K07
engageret	S4
stabil	K07
ansvarsbevidst	S4
pligtopfyldende	A1
udfører dine opgaver med høj kvalitet	S4
situationsfornemmelse	K02
fleksibel	A1
overkomme fysiske arbejdsopgaver	S4
godt humør	S6
kørekort til personbil b	K10
afholde status	K06
plukkes	S2
pakkes	S4
fysik i orden	K07
fysisk arbejde	S4
går engageret til dine arbejdsopgaver	A1
stabil	K07
pligtopfyldende	A1
går op i detaljen	A1
effektiv	A1
engelsk	L1
ordenssans	K04
grundig i dine arbejdsopgaver	S4
god fysik	K07
fysisk arbejde	S4
sætter borgeren i centrum	S4
lære nyt	K01
humoristisk sans	K08
samarbejde	S4
lungemedicin	K09
varetage specialiserede og almene lungemedicinske opgaver	S2
videreudvikle området	S4
bidrage på visionærvis og aktivt til at udvikle specialet yderligere	S1
indgå engageret i både videreudvikling og drift af det lungemedicinske speciale	S4
understøtte en kultur hvor der lægges vægt på et godt og dynamisk arbejdsmiljø	S4
kommunikative egenskaber	S1
samarbejde tværfagligt	S1
bidrage aktivt til forskning uddannelse og kvalitetsudvikling	S4
gå aktivt ind i afdelingens kvalitetsarbejde	S4
optimering af patientforløb og patient- og pårørendeinvolvering	S1
jordemoderfaget	K06
konsultationsarbejde	S1
barselsklinik	K99
ammeklinik	K99
fleksibel	A1
hjælpe med at passe svangre- og barselspatienter	S3
hjælper hinanden på tværs af afsnittene	S1
klinisk sparring	K09
vejlede studerende	S1
deltage i projektarbejde	S4
stan certificeret	K07
jordemoderfaglig visionær	S4
pædagogiske empatiske og kommunikative evner	S1
Glad	K99
imødekommende	A1
initiativrig	S2
fleksibel	A1
omstillingparat	S6
arbejde med at udvikle samt forbedre klinisk praksis	S4
forsknings- og udviklingsarbejde	K07
patientsikkerhed	K09
patientinvolvering	S1
rationel drift	K04
rengøring	S6
tøjvask	S6
udviklingsorienteret	S1
planlægge en inklusionsårsplan	S4
være en del af skolens ressourcecenter/pædagogisk læringscenter	S1
samarbejde med lærere elever forældre ledelsen samt øvrige eksterne samarbejdspersoner	S1
godt funderet skriftligt og mundtligt	S1
inklusionsfremmende aktiviteter	K10
arbejde selvstændigt og tværfagligt	S1
sætte din viden i spil i forhold til kolleger med forskellige faglige baggrunde	S4
mangfoldighed	K99
fællesskaber	K06
inkluderende læringsmiljøer?	S1
inkluderende læringsmiljøer	S1
omsorg	K06
kontakt	S1
udvikling af børnenes muligheder for at deltage i læringsfællesskaber ( leg klasse- og læringsrummene frikvarter	S1
være en del af skolens ressourcecenter/pædagogisk læringscenter	S1
udvikler en observations- og sparringskultur	S4
støtte lærerne forældrene og eleverne i et struktureret og forudsigeligt læringsmiljø	S1
sparring med lærerne	S1
stimulering og udvikling af fællesskab sociale og personlige kompetencer hos eleverne	S1
understøtte enkelte eller grupper af elever	S1
social træning	S1
samarbejde tæt med en række af skolens lærere	S1
arbejde med retningslinjer for datamodellering	S1
datamodellering	K06
gøre en forskel	A1
udnytte værdien af store datamængder optimalt?	S4
tænker strategisk	S4
arbejde med model- og datastandarder	S1
arbejde i tæt samspil med it-arkitekter og udviklere	S1
designe og optimere løsninger på vores nye dataplatform	S5
designe og implementere værdiskabende datamodeller	S5
udforske analytiske muligheder	S2
rådgive og støtte organisationen i strategisk anvendelse af data	S4
implementere og vedligeholde governance	S1
definere metoder og processer for udvikling og drift	S4
udvikle og implementere strategi og roadmap	S4
designe og kommunikere standarder for datamodellering og metadataregistrering	S1
støtte og køre vores data governance-program	S1
igangsætte nødvendige initiativer i projekterne	S4
engagere dig i datakvalitetskontrolprocesser	S4
dokumentere og vedligeholde fysisk og logisk dataarkitektur	S2
understøtte daglige issues vedrørende datadokumentation	S1
etablere og vedligeholde reference- og løsningsarkitektur	S4
målbilleder	S6
guidelines	K04
principper	K99
udnytte data på nye måder	S5
arbejde dedikeret	S1
sikre effektiv udvikling af værdiskabende løsninger	S4
information/data	K06
processer	K07
dataintegrationer	K06
implementering af nye it-løsninger	S1
arbejde på et højt abstraktionsniveau	S1
designe og/eller omsætte tekniske beskrivelser og behov til tekniske og datamæssige løsninger	S2
samarbejde	S4
sikre den nødvendige koordinering og videndeling	S4
formidler	S4
holder hovedet koldt i pressede situationer	A1
arkitektur	K07
data	K06
ny teknologi	K06
mod på at lære nyt	S1
arbejde projektorienteret	S1
Datamodelleringskoncepter	K99
data vault	K06
Snowflake	K99
3	K06
datamodeller på bl.a	K06
xml	K06
CSV	K99
AVRO	K99
PARQUET	K99
Arkitekturrammeværk	K99
zachman framework	K06
Datamodelleringsværktøjer	K06
ea sparks	K06
Qualiware	K99
Datakvalitetskoncepter	K99
cloud-baseret it-arkitektur eller udvikling	K06
etl	knowledge
data lake	K06
metadata registrering og lineage	K06
design af løsninger i en offentlig kontekst	S1
fda	K06
OIO	K99
opbygning af data flows	S5
sikre beboerne en høj livskvalitet	S4
omstille dig til nye rutiner	S1
deltage i dækningen af vagter ved sygdom	S3
arbejde med plejen af ældre	S3
arbejde med at dokumentere	S2
KOS2	K99
betjene psykiatrisk center	S3
tjeneste	K10
udadvendt	K99
energi- og kraftværksområdet	K07
projektledelse af teknisk komplicerede og udfordrende energianlæg	S1
-biomassekonvertering af fossilfyrede kraftværker	K07
-optimering af kraftværker og anlæg	S2
-projektering af nye kraftværksanlæg	S1
-drift- og vedligeholdelse af anlæg	K07
task force indsats	S4
haverier	K04
due diligence projekter	K04
feasibility studier	K09
strategi indsatser	S4
arbejde tæt sammen med kunder	S1
opbygge gode relationer til netværk	S1
arbejde i et dynamisk miljø	S1
interesse for at udvikle dig	S1
energi	S2
kraftværker	S4
miljø	K07
energiområdet	K07
projektledelse	K04
energiområdet	K07
byggeri og anlæg	K07
strukturere projektets faser	S4
sikre effektiv projektafvikling	S4
projektering/projektledelse	K04
komplette projektforløb	K04
planlægning	S4
projektering af anlæg	K07
udbud samt tilsyn	K10
projekt- og byggeledelse	K07
kraftværker	S4
miljøanlæg	K10
kontekst- og forretningsforståelse	K04
arbejde systematisk	A1
arbejde i et internationalt miljø	S1
dansk	L1
engelsk	L1
frisk sælgende personlighed?	S1
kontakte virksomhedsledere og andre ansættende ledere i mindre og mellemstore virksomheder	S4
arbejder selvstændigt	A1
højt aktivitetsniveau	S8
salgsdialoger	K04
skaffe nye kunder i butikken	S1
god energi	S2
indstilling til at ville lykkes	S1
vindermentalitet	S4
motiveres af et ja tak	S1
ikke lader dig slå ud af et nej tak	S1
social	K04
skaber en god stemning	S1
New Bizz	K99
bagerfaget	K07
kvalificeret	S4
energisk	S3
reservedels indkøb håndtering udlevering og salg	S6
værkstedsplanlægning	K04
indskrivning	K02
skadekoordinering med eksternt pladeværksted	S4
telefonekspedition	S2
Engageret	K99
selvstændig	S4
ansvarlig	A1
serviceminded	S1
Dracar+	K99
Suzuki	K99
sælge produkter	S1
tillid	K99
loyalitet	S4
smil	K99
positiv energi	S2
samarbejde	S4
koordinering	S4
positiv indstilling til samarbejde problemløsning og tilgang til andre mennesker	S1
pet/ct	K08
spect	K99
fysiologi	K02
kombinere fysiologi med anatomi	S1
anatomi	K05
diagnostik	S1
stadieinddeling af sygdomme	K10
terapimonitorering	K99
matematiske begavelse	S2
visuelle betragtende hjerne	K01
behandling med radioaktive lægemidler	K09
visitation	S3
beskrivelser af forskellige typer undersøgelser	K03
fysiologisk og/eller medikamentel belastning af hjertet	S8
hjerteperfusionsundersøgelser	K09
klinisk fysiologi	K09
nuklearmedicin	K99
abcde principperne	K06
måle værdier	S2
måle crp hæmoglobin og leucocyter	S2
stixe urin	K10
tage dyrkninger	S6
sonde	K07
urin-kateter	K09
pvk	K06
CVK	K99
sc-nål	K06
hjerte lunge speciale	K10
forebygge indlæggelser	S6
sikre tæt samarbejde med relevante samarbejdspartnere	S1
skabe høj kvalitet i borgerens behandlingsforløb	S4
understøtte en ensartet og høj kvalitet på tværs af sektorer	S4
sektorovergange	S4
relationskompetencer	S1
faglig nysgerrighed	S1
varetagelse af sygeplejeopgaver	S4
håndtering af ustabile borgere	S3
arbejde løsningsorienteret	A1
arbejde selvstændigt	A1
tage beslutninger i pressede situationer	S4
fejlfinding på og reparation af produktionsmaskiner	S8
forebyggende vedligehold	K10
planlægning af større eftersyn	S3
tilsyn og planlægning af arbejdsopgaver for eksterne håndværkere	S4
optimering af produktionsudstyr	S4
projektarbejde	S4
teknisk profil	K07
el arbejde	L1
procesteknisk forståelse	S1
større rørinstallationer	K07
regulering af tryk og flow	S8
el-styringer	K07
industrigasser	K99
prioritere	S4
planlægge	S4
overblik	S3
arbejder struktureret og pligtopfyldende	A1
kommunikations- og samarbejdsevner	S1
positiv	S1
engageret	S4
arbejder selvstændigt og kvalitetsbevist	A1
fokus på overholdelse af deadlines	S3
bidrager til et højt sikkerhedsniveau	S4
godt humør	S6
søge og dele viden	S4
engelsk	L1
it	K07
inspirere	S4
udfordre	S1
rumme	K99
aktiv medspiller	S1
anerkende tilgang	A1
respekterer og gerne udfordrer kollegers idéer og pædagogiske arbejde	S1
ledelse	S4
personaleledelse	K04
samarbejde	S4
drive og videreudvikle et rigtig godt børnehus	S8
trivsel	K99
lede en integreret institution	S4
faglighed	S1
lytte	K06
reflektere	S4
omsætte visioner til handling	S4
lydhør	K99
inddrager kolleger	S1
træffe beslutninger	S4
gå forrest	S6
overblik	S3
rummer samtidig nærvær og de små detaljer	S1
arbejde videre med mange af de tiltag vi allerede har i gang	S4
inspirerer også til kommende tiltag	S4
synlig i huset	S6
trives med de forskellige aspekter jobbet byder på	S1
ledelsesopgaver	S4
dialogbaseret	K99
anerkendende	S1
videreformidle	K99
inspirere	S4
kommunikerer ligeværdigt imødekommende og med tydelighed	S1
it-systemer	K05
humor	S1
humør	K99
skabe det gode børneliv	S4
indgå i et mindre sjak	S1
vejen som arbejdsplads	K07
kloak	S2
fiber	K07
fjernvarme	K07
Håndmandsarbejde	S4
vejen som arbejdspalds	S4
fjernvarme	K07
kloak	S2
fiber	K07
dansk	L1
troværdigt og inspirerende sætte retning	S4
stå i spidsen	S1
skabe engagement og følgeskab	S1
skabe en stabil og autentisk forbindelse	S1
sætte dagsordenen	S4
være værdiskabende	S4
levere skarpt fagligt og strategisk med- og modspil	S4
matche kravene til ledelse af den faglige indsats forhandlinger håndtering af vanskelige sager	S4
lang videregående uddannelse	K01
juridisk kompetence	S1
robust	K07
gennemslagskraft	K07
direkte ledelse	S4
ledelse af ledere	S4
ledelse	S4
personalejura	S4
arbejdsmiljø	K10
kompetence- og organisationsudvikling	S4
tillidsfuldt og konstruktivt samarbejde	S1
integritet	K10
ordentlighed	A1
loyalitet	S4
sikre såvel kompetent ledelse udvikling og styring af egen afdeling som den tværgående strategiske udvikling af hele organisationen	S4
hr-området	K07
telefonkontakt internt og eksternt	S8
administration for caféerne	K09
behandle og bogføre diners eurocard og pbs	S3
kronisk medicinsk speciale	K02
