design and refine every touchpoint of the customer journey	S1
design and refine every touchpoint of the customer journey	S1
tackling new problems and perspectives	S1
designing tools materials and stimulating content	K02
drive internal strategy and innovation	S1
CX	K02
content output	S1
impact technology can have on customers	S1
deliver a meaningful member experience	S1
researching and defining opportunities	K04
conduct interviews	S1
bring customer experience to life	S1
creating content	S1
deliver clear and attractive design outcomes	S1
defining our product roadmap	K04
delivering the right products and services	S1
driven by purpose	S1
cx design methodologies	K02
user journey planning	S1
qualitative research methods	K01
eye for beautiful design	K02
passion for innovative solutions	S1
take sketches and paper prototypes through to high quality design output	S2
communicator	S1
articulate clearly and effectively	S1
working both independently	S1
leading on collaborative design discovery	S1
Keynote	K04
Figma	K02
illustrator	K02
google workspace	S1
work with business leads	S1
structure draft and negotiate agreements	S1
advise clients on the various legal risks business strategies and other issues	S1
commercial transactions	K01
business operations	S1
contract drafting	K04
negotiation	S1
advisory	K04
provide strategic business and legal advice	S1
develop a comprehensive long-term approach	A1
manage and resolve legal issues	S1
commercial transaction support	S1
LLB	K01
qualified lawyer in eu member state	S1
media	K02
publishing	K02
internet companies	S1
drafting and negotiating technology and content acquisition licensing and distribution agreements	S1
current media and digital platform landscape	K02
thrive in a fast-paced hard working environment	A1
complete projects in a timely fashion	K02
teach children	S3
applied behaviour analysis	S1
psychology	K01
natural enthusiasm and energy to work with children	S3
interpersonal and communication skills	S1
listen	S1
understand	A1
educate	K01
advise	A1
present	K02
work as part of a professional team	S4
taking direction from managers	S4
giving and receiving feedback	S1
complement teachers’ delivery of the national curriculum	K01
develop the skills and strategies of other support staff	S4
work collaboratively with teaching staff	S1
assist teachers	K01
management/preparation of resources	S4
encourage pupils	S2
provide support	S1
support the inclusion of the pupil	S3
implement changes instructed by the bcba	S2
interpret and analyse data	S2
provide constructive feedback	S1
improve the functioning of the programme	S2
maintain consistency	A1
data analysis	K01
liaise with bcbas	K04
communicating data to a bcba	S1
ensuring that the data files are up to date	S1
identify the need for prepare and maintain teaching materials resources and data sheets	S1
monitor progress	K04
reviewing acquisition data behaviour frequency maintenance and generalisation	S2
identify short-term targets	A1
provide 1:1 intensive teaching sessions	K01
aba	S2
provide 1:1 support	S1
principles of aba	K04
enable inclusion	S1
support the child to engage with others participate and generalise skills	S3
use behaviour management strategies	S1
contribute to a purposeful learning environment	S1
encourage the pupil to interact and work cooperatively	S1
understand and implement school child protection procedures	S3
comply with legal responsibilities	S1
provide 1:1 support using the principles of aba	S1
aba	S2
enable inclusion	S1
support the child to engage with others participate and generalise skills	S3
provide personal care	S3
teach independence using the principles of aba	S1
aba	S2
record progress data	K04
working with children with autism	S3
aba	S2
support a child to access the national curriculum using aba principles	S3
communicate in a polite and professional way	S1
communicate effectively	S1
provide a customer-oriented service	S2
QCF	K01
overseeing and managing a small consistent highly trained and motivated staff team	S4
delivering care and support	S3
delivering childcare	S3
focused on obtaining the best outcomes	S1
demonstrate good leadership	S4
organise and support staff	S4
deliver the best possible care	S3
making sure the manager is aware of any and all incidents	S4
supervise and mentor staff	S4
organise work patterns	S1
facilitate training	K01
involved in liaising	S2
access appropriate services	S1
promote professional good practice	S1
quality control monitoring	K04
social care and well-being act 2014	S1
regulation and inspection of social care act 2016	S3
ensuring the smooth running of your shift	A1
ensuring that high standards are maintained	S2
support residential care workers	S3
building a strong positive work ethic	A1
ensuring the home is physically safe	S2
assisting with health and safety responsibilities	S3
completion of corresponding records	S2
providing a good quality home environment	A1
creating and developing links between the community and the home	S1
enable children to participate fully in the life of the community	S3
assist in the completion of impact assessments	S4
matching documentation	S1
oversight of the placement of children and young people	S3
ensuring the assessed needs of young people in the home can be met	S3
administering a system for monitoring progress	S2
preparing or overseeing each individual placement plan	S4
reviewing such plans	K04
ensure children/young people are supported to achieve	S3
contribute effectively to each child's individual placement plan review	S3
supporting children/young people	S3
review process	K01
ensuring that there is a comprehensive plan in place	S4
assist when requested in the completion of the rota	S4
ensuring there are always staff available	S4
promote an open and supportive atmosphere	S3
identifying the training and development of staff	S4
meet the objectives	S2
induction supervision and appraisal of staff	S4
supportive	S1
offer constructive feedback to staff	S1
ensure that you keep and maintain accurate records	S1
managing and monitoring paperwork and records	S3
advising on best practice	S4
ensuring that services are delivered	S4
statement of purpose	S1
managing and operating budgets	S4
sourcing appropriate services	S1
support the childcare practices	S3
provide regular budgetary updates	K04
ensure children and staff are aware of all the procedures	S3
qcf level 3	K01
l5 in leadership and management in health and social care	S3
registration and inspection social care act 2016	S3
service requirements	S2
working in a care setting	S3
managing budgets	S1
taking part in an inspection	S2
reasoning numeracy literacy	K01
technology skills	K01
work as part of a team	A1
working closely with colleagues and other agencies	S1
solve problems	A1
work within the principles of the children’s act and social services and wellbeing act	S3
children’s act and social services and wellbeing act	S3
child protection issues and procedures	S3
manpower	K04
planning/development/skills mix	K04
develop and encourage professional growth in others	S1
budgetary requirement and management	K04
lead effectively	A1
leadership abilities	K04
organisation and leadership skills	S4
lead motivate and influence others	S1
interpersonal skills	S1
approachable	K02
honest	A1
reliable	A1
accountability	A1
be responsible for the work undertaken	S2
driving licence	K01
RGN	K04
RMN	K04
RNLD	K01
nmc pin	K04
NMC	K01
sen	S1
supporting sen pupils	K04
learning difficulties	S1
autism	K02
SEMH	K04
work in a variety of ages and abilities	S3
learn about the curriculum and teaching techniques	S1
sen	S1
asc	K06
supporting sen – asc & semh	K04
SEMH	K04
proactive	S2
committed	A1
enthusiastic	A1
supporting sen	S1
build strong and productive relationships	S1
motivated	A1
ambitious	K02
creative	K02
driven	A1
put a personal touch on the menu	S1
brunch trends	K02
american comfort food	K02
lead a small team	K04
kitchen's day to day operations	S2
stock control	S2
compliance	S1
gp control	K04
managing supervising and training your kitchen team	S4
ensure high standards of hygiene are maintained	S3
come up with different exciting and unique brunch and evening dishes	K02
demonstrate leadership	K04
menu planning	K04
coshh	A1
hse	K04
EHO	K04
food hygiene qualification	S3
mechanical background	K02
assembly	K01
workshop	K01
use hand tools	S1
work from drawings and works instructions	S2
follow health & safety guidelines	S3
show willingness to help out	A1
work ethic	K02
food service	K02
striving for the best	A1
deliver first class customer service	S1
delivering a professional service	S4
ensuring all guests are given a warm welcome	S1
displaying excellent product knowledge	S1
help guests make the best choices	S2
ensuring all guests are treated in a professional manner	S2
taking orders promptly	S4
answering queries	S1
ensuring all areas in the restaurant and bar are clean and tidy	S4
support the kitchen with food service	S2
ensure guests receive their food in a timely manner	S2
work on the bar	K02
creating coffees and hot drinks	K02
providing a professional bar service to guests	S2
moving large tray of vegetables	K02
manual handling tasks	A1
food preparation	K02
retail sales	K02
customer service	S1
winning attitude	A1
food preparation	K02
bread and cookie baking	K02
ensure food storage and preparation areas are maintained	S3
health & safety and audit standards	S3
comply with food code of practice	S3
till operator	K04
monitoring stock levels	K02
checking in deliveries	S2
complete daily and weekly cleaning schedules	S4
follow security & safety procedures	S3
maintain a safe working environment	A1
maintain high personal presentation	S1
work as a team member	S4
deliver a high standard of service	S2
serve and add value to customer needs	S1
ensure hygiene standards are met	S3
meet and greet guests	S2
deliver exceptional customer service	S1
using flt to move stock throughout warehouse	S2
loading/ unloading trailers	S4
use of hand scanners & pc’s	S1
physically fit	A1
time keeping	S1
hard working attitude	A1
english	L1
work as a team & alone	A1
flt counterbalance licence	K04
administration	K01
diary management	K04
typing of correspondence	S1
attending meetings	S1
sales support	S1
processing invoices	S2
producing sales quotations	S2
team player	A1
flexible	A1
assist	S1
it	A1
word	L1
excel	K02
outlook	K02
powerpoint	K02
communicator	S1
build and develop strong relationships	S1
english	L1
valid passport	S1
full driving license	K04
travel	S1
working in a small team	S4
enjoy a variety of tasks	S4
aptitude to hygiene	S3
produce brilliant creative copy	K02
adept at taking a strategic direction and bringing ideas to life through the written word	S1
defining the brand voice and developing it through use of language and tone	S1
detail-oriented	A1
meticulous	K04
uphold quality standards of style and grammar	S1
produce high-quality edited messaging and content	S1
manage your time effectively	S1
prioritize and manage multiple projects	S4
working collaboratively	S1
communicator	S1
contribute to the culture	K02
oral and written communication skills	S1
interpersonal skills	S1
interact with people at all levels	S1
copywriting skills	S1
confident yet sensitive interviewing skills	K04
sub editing	K02
proofing	K04
attention to detail	K02
manage own workload	A1
work to deadlines	S1
writing	S1
brand strategy	S1
brand campaigns	S1
pitches	S2
proposals	S1
social	S1
internal communication	S1
office	K02
g-suite	K02
InDesign	K02
illustrator	K02
Keynote	K04
marketing	K02
creative writing	S1
communications	S1
hard worker	A1
customer service	S1
communicate respectfully with clients and the public	S1
multi trades work	S1
rail	K04
full uk driving licence	K04
flexible	A1
carpentry	K04
bricklaying	K04
plastering	K04
concrete repairs	K02
paving	K04
painting	K02
replacing doors and windows	S1
cscs card	K04
certification of skilled trades	S2
tfl certificate	K01
ce ( class 1 ) licence	K01
cpc	K06
digital tachograph	K04
Tipper	A1
walking floor	K04
wtd's ( working time directive	K04
health & safety conscious	S3
flexible	A1
cpc driver qualification card	K04
digi-card	K02
licence - category c+e	K01
Tachos	K04
cscs card	K04
ppe	S1
CSCS	K01
providing a world class patient service	S3
liaising with the manager	S4
drive performance in the store	S6
leading and inspiring fellow staff	S4
ensuring the clinic runs successfully and efficiently	S3
providing patients with the best optical products	S3
dealing with any enquiries effectively	S2
fulfilling management duties	S4
store operations and dispensing duties	S4
business and marketing acumen	S1
deliver the best customer service journey	S1
running of the store	S6
reporting to management	K04
striving to meet targets	S4
driving performance and sales	S6
motivating and leading staff	S4
deliver exceptional patient care	S3
smooth running of the clinic	S3
managing fellow staff members	S4
communicating any ideas or concerns	S1
ensure the best performance and development	S4
challenging the team	A1
deliver the best service	S1
excel targets	S1
dispensing duties	K04
recommending frames lenses and contact lenses	S1
reception and admin work	S2
diary upkeep	S2
patient appointments	S3
recruitment	K01
upholding to nhs guidelines	S1
nhs guidelines	S1
maintaining presentation and visual aesthetics of the store	S6
promoting the business	S1
optical	K02
accountable for nominated clients	S2
maximise profits	S2
develop the business	K02
ocean import	K02
commercial mindset	A1
demonstrate & generate enthusiasm	A1
'can-do' attitude	A1
identify problems	A1
respond in a timely fashion	S1
demonstrate personal drive	A1
communicate effectively	S1
active listening	S1
smart	S1
enthusiastic	A1
web development	K02
html	S1
css	S1
less	A1
SCSS	K01
PostCSS	K01
angular	K02
react	A1
js	S2
java	K02
c#	K02
client-side compatibility	S1
performance considerations	S2
debug issues in a full stack environment	S1
sql	S1
team player	A1
engage with colleagues	S1
communication skills	S1
independently conduct the experimental work	S2
design execution and analysis of phosphoproteomics experiments	S3
phd degree	K01
mass spectrometry-based quantitative proteomics	S2
phosphoproteomics	S3
molecular biology	K02
vector construction	K02
protein synthesis in e	S3
post-translational modifications	K04
b	K04
english	L1
communication and collaborations skills	S1
independence	K01
paper and project writing	S1
designing existing transport construction maintenance processes	K04
work in a dynamic and international team?	S4
developing and illustrating processes and concepts	S2
transport installation and maintenance of wind turbines	S2
develop construction concepts	K02
ensure that market requirements and best practice is included	A1
drive new product development	K02
ensure full value chain perspective in new products	S1
optimize construction	K02
cost reduction	K02
quality improvements	S1
collection of improvement suggestions and best practice	S1
plan and ensure development of global construction work processes	S4
ensure that requirements from the operational business are included in the wind turbine & tools designs	A1
create new concepts for turbine installation	S1
optimize existing processes	A1
testing verifying at site	S2
production	K02
supply chain	S1
production	K02
installation	K02
maintenance	K02
B.Sc	K04
production mechanical electrical marine engineering	K01
lean	K04
value stream mapping	K02
process mapping ( production or development	K02
develop processes or concepts for larger components	S1
risk assessment tools	S3
PFMEA	K04
process mapping	K01
communication	S1
presentation skills	S1
english	L1
cooperating with colleagues	S1
proactive mindset	A1
keep an overview in stressed situations	A1
outgoing	A1
project management skills	S4
handle complex pricing calculations?	S2
communicate quantitative analyzes	S1
influence the sales of large-scale projects?	S2
supporting the electricity sales team	K04
pricing calculations competitor analysis	K01
benchmarks	S2
prepare pricing calculations and price-/cost analysis	S2
present the calculations	S2
prepare business cases and benchmarks	S4
support the sales strategies	S1
build and maintain a database of submitted offers/kpis	S4
analytical proactive and structured workstyle	K04
high-quality mindset	K04
numerate	S2
communicative skills	S1
interact with your commercial and technical colleagues	S1
working independently	S1
build relationships across the organization	S1
innovative	A1
solution-oriented	A1
masters degree	K01
finance	K02
economics	K01
pricing and complex analysis	K04
microsoft powerpoint	S1
excel	K02
visual basic	K02
pivot	K02
capex/opex business cases	S1
english	L1
danish	K01
swedish	K02
norwegian	K02
pig production	K02
feeding	S3
moving	K04
castration	K04
insemination	S3
monitoring the animals health	S3
driving license	K04
desire to work with pigs	S3
work closely with developers designers and marketers	S1
develop beautiful campaigns	K02
create outstanding experiences	S1
maintain our frontend stack	K04
contribute with beautifully crafted layouts	K04
scalable and modulable code	S2
developing and integrating great frontend experiences	S4
collaborate with a team of designers copywriters and marketers	S1
craft and deliver exceptional landing pages and experiences	S1
deliver maximum impact	A1
creative solutions and ideas	S1
solve challenges	S1
improve our overall website & campaign performance	S2
build and maintain a design system and development process	S4
markup	K04
javascript	S1
organize and maintain markup javascript and css	S1
css	S1
developing quality well-performing and scalable code	K04
javascript	S1
html	S1
css/sass	S1
git	A1
angular	K02
react	A1
typescript	K02
restful apis	S2
responsive design media queries	K02
adobe creative suite	K02
sketch	K02
invision	K02
wordpress/php	K02
scrum/agile	K04
general management and development of the employees	S4
budget and resource allocation	S1
ensuring timely and efficient project execution	S4
drive the development of technology	K02
master or phd degree	K01
chemical/biochemical engineering	K04
bio(chemistry	K02
food science	K02
project leadership	K04
interfaces between external/internal customers	S1
commercial insight	K02
production	K02
drive technological advances	S1
increase expertise level in the department	S4
lead and motivate people	S4
communication skills	S1
people management	K04
implementation of successfactors	S2
compensation and performance management	S4
optimize and manage existing reward and benefits programmes and processes	S4
support the business priorities	S1
ensure local compliance	A1
develop global frameworks policies and programmes	S1
manage hq reward programmes	S1
perform benchmarking	S2
market analysis	K02
drive the annual salary review	S2
benchmarking work for salary range setting	S2
advise and train managers and hr business partners	S4
support strong anchoring of rewards policies and programmes	S4
rewards in a global context	S1
delivering a broad range of reward initiatives	S4
masters degree	K01
business administration	K01
hr	K04
finance	K02
economics	K01
excel	K02
powerpoint	K02
working with numbers and data	S1
strong focus on details	K04
building relationship with your stakeholders	S1
engaging with colleagues	S1
english	L1
registered surgeon	K04
patient-centred	S3
inclusive	K02
provide your patients with a safe and effective course of treatment	S3
see it systems as an aid in your work	S1
good humoured	A1
loyal	A1
dedicated	S1
flexible	A1
engage people in the streets	S1
conveying knowledge	S1
Extroverted	A1
energetic	A1
excited about meeting new people	S1
enjoy interacting with many different characters	S1
result oriented	A1
work constructively towards reaching goals	A1
good at acquiring new skills	S1
continuously working on your own development	S4
english	L1
valid visa to work in denmark	S1
read and understand addresses and house numbers	S1
team work	A1
cooperation	S1
walk on stairs	S1
ride a bike	K02
acceptable criminal record	K04
read the latin alphabet	L1
motivated	A1
good structure	K02
follow a route	S4
register when a shipment is delivered	S2
work professionally with high quality	A1
reliable	A1
responsible	A1
trustworthy	A1
responsible	A1
conscientious	S2
work in all kinds of weather at night	S2
good colleague	S1
lead and implement an aligned strategy	S4
drive the digital supply chain community	S1
developing and implementing a digital supply chain strategy	S1
sharing best practice	S1
developing new initiatives	S1
identify digital supply chain initiatives	S1
collaborate with internal customers	S1
agile program management	S4
digital solutions	K02
ensure a continued support knowledge sharing across segments	S1
digital supply chain	S1
energetic	A1
willing	A1
find compromises between multiple and sometimes conflicting interests	A1
strategic mindset	A1
big picture thinking	A1
deep dive	K02
customer obsession	S1
deliver results	K02
ownership	S1
implementation	K02
digital savvy	K02
data analytics	K02
process transformation	K02
iot ( industrial automation	K04
e-commerce	S6
startups	S1
agile	K02
communication presentation and facilitation skills	S1
well-structured	K04
independent working style	K02
willingness to travel	S1
curious	K02
enjoy learning	S1
develop new ideas	S1
create value	K02
manage risk from the sale and purchase of power	S4
work both independently and collaboratively	S1
deliver team objectives	A1
coordinate tender responses	S1
participate in contract negotiations	S1
build and maintain good working relationships	S1
acquiring knowledge	S1
developing understanding	K02
support team activities	S4
business	K02
economics	K01
maths	K05
desire to learn and develop	S1
proactive	S2
commercially astute	S2
problem-solving attitude	A1
team player	A1
thrive in an international environment	S1
communicator	S1
english	L1
self-starter	S2
enjoy a fast-paced work environment	K04
market analysis	K02
communication and analytical skills	S1
insights creation and commenting	K04
creation/ optimization of ppt	S4
revising stimulus material for research projects	S2
analysis of quantitative data	K04
working with multiple data sources and combining them into relevant insights	S1
dialogue and follow-up with research vendors	S1
contribute to insights communication	S1
marketing	K02
marketing	K02
business	K02
cand.merc	S4
cand.negot	A1
cand.oecon	A1
marketing	K02
market research	K02
thinking visually	A1
communicate your ideas and messages	S1
ambitious	K02
goal oriented	A1
show engagement	A1
demonstrate positive thinking	A1
can-do attitude	A1
see great challenges in being tasked with tactical as well as strategic marketing problems	S1
business understanding	S1
strategic	K02
analytical	K02
communicative	S1
dive into the numbers	S1
analyze	K02
turn numbers into actionable insights	A1
ms office tools	K04
excel	K02
PPT	K01
SPSS	K01
structured working style	K02
take on task responsibilities	S1
contribute with ideas and input	S1
english	L1
picking and packing	K04
picking and packing orders with a hand scanner	S4
receiving and registering goods	S6
controlling returned goods	A1
palletizing and shipments	S2
perfectionists	K02
manual work	K04
precise	K02
goal oriented	A1
team players	A1
helpful	A1
show initiative	A1
transport	S1
logistics	S1
people management and development?	S1
motivate and set the direction	S4
ensuring the pace of production	K02
develop your team	A1
professional leadership	K04
set the direction	S4
coach and develop your team	S4
ensure that production runs in accordance with gmp	K02
gmp	S1
enabling your team to deliver in a timely and flawless manner	S4
run or participate in systematic problem solving	A1
science	K02
pharmaceutical production	K02
managing people	S1
management	K04
gaining trust and respect	S1
structured	K02
keep the overall view	K04
thrive in a busy and constantly changing working day	S4
prioritize	S4
communication and collaboration skills	S1
gmp	S1
lean	K04
work in a structured and targeted manner	S1
never compromise on quality	A1
ensure continuous improvements	S2
motivated	A1
ambitious	K02
reliable	A1
maintaining cell lines	K02
perform molecular biology techniques	K02
pcr restriction	K04
cloning reactions	S3
dna/rna and protein purification procedures	S3
setting up routine imaging and cell sorting experiments	S3
sample preparation	K02
assist with the overall maintenance of the lab	S3
administration of several databases	S3
plasmids	S2
cell lines	K02
mouse colony	K02
antibodies	S3
purchasing	K02
stocking	K04
participate in the research projects	K01
responsible for training and providing technical assistance	S4
tissue culture techniques	K02
cell sorting	K04
working independently and organized	A1
self-motivated	K04
interpersonal and communication skills	S1
danish	K01
english	L1
basic molecular biology	K02
mouse research	K02
increase the value of it systems	K04
maintain and develop effective relationships?	S1
working in a dynamic environment?	K02
support your colleagues	S1
computer equipment	K02
telephony	K02
application support	S1
familiarise yourself with your colleagues' situation	S1
use your service skills to assist them as efficiently as possible	S4
prioritise incoming requests	S4
tick each task off the list	S4
providing first-line support	K04
communicating with and informing users	S1
resolving technical it issues	A1
providing application support	S1
receiving recording and referring cases to the appropriate team	S3
accurately executing specified procedures	S2
co-operation	S1
communicator	S1
it support	S1
microsoft's systems	K02
itsm tools	K04
application support	S1
work independently	S1
seeing your duties through to the end	S2
take a structured approach to work	S1
prioritising your tasks and identifying those that are the most important	S4
thrive in an outgoing role	S4
communicate concisely and accurately	S1
providing the best possible service	S4
demonstrating persistence	S2
patience	S2
attentiveness	A1
enjoy working in a dynamic environment	A1
english	L1
security clearance	K04
drive development of the software product roadmap	K04
find innovative solutions	S1
stays on top of current trends	A1
develop long term plans	K04
embrace work load enthusiastically	A1
comfortable with a fast paced quickly changing work environment	A1
technical and business skills	S1
articulate the vision in the way others will understand	S1
project management	S4
b2b market	K01
ux	S2
development	K02
define value proposition customer segments and customer channels	S1
lead the product development process	S4
correctly brief the other departments	S2
challenge outcomes	S1
english	L1
czech	S1
product / project management	S4
ux development process	S3
user testing	S1
understanding the results	S2
communication skills	S1
passion for a change	S1
establish rapport	S1
bond with a business partner	S1
think outside the box	K02
clearly and professionally present information	S1
generation and development of new and existing business opportunities	S1
credible	A1
lead generation	K02
appointment setting	K04
proposal development and presentation	K02
manage the international sales	S2
international sales	K02
business development process	K01
building new business relationships	S1
building on existing success	K04
reporting to the head of sales	S2
build new major business opportunities	S1
sales canvassing	K02
develop implement and manage sales and relationships	S1
negotiate and close business	S1
exceed targets	S1
being in regular telephonic and face to face contact with clients	S1
generate leads	S1
market and client-research	K02
break into medium to large organisations	S4
manage and be part of all processes of a typical sales cycle	S4
monitor competitor activity and market dynamics	S2
recognise and recommend improvements to existing processes	S2
improve revenue performance	S2
inspiring	A1
persuasive	S1
convincing	K02
sales canvassing	K02
cold calling	S1
booking meetings on the phone	S1
outgoing	A1
javascript	S1
reactjs	A1
java	K02
javascript	S1
reactjs	A1
java	K02
solving business problems	A1
innovation and engineering practices	S1
apply your depth of knowledge and expertise	K04
software development lifecycle	K02
partner continuously with your many stakeholders	S1
stay focused on common goals	S1
motivated	A1
deliver of a next-generation analytics products	K04
bs/ba degree	K01
application data and infrastructure architecture disciplines	K01
architecture	K02
design	K02
developmental toolsets	K04
industry-wide technology strategies and best practices	K01
work in large collaborative teams	S1
achieve organizational goals	A1
building an innovative culture	K02
java	K02
javascript	S1
business analysis	K02
development	K02
maintenance	K02
software improvement	K02
html5	S1
javascript	S1
developing multithreaded scalable concurrent applications	S2
node js ( server side and tooling	K04
react	A1
java	K02
spring	K02
java-ee	K02
java	K02
spring	K02
java-ee	K02
solving business problems	A1
innovation and engineering practices	S1
apply your depth of knowledge and expertise	K04
software development lifecycle	K02
partner continuously with your many stakeholders	S1
stay focused on common goals	S1
bs/ba degree	K01
java	K02
spring boot	K02
nosql	A1
message	S1
cloud	K02
ci/cd	K02
application data and infrastructure architecture disciplines	K01
architecture	K02
design	K02
developmental toolsets	K04
industry-wide technology trends and best practices	S1
work in large collaborative teams	S1
achieve organizational goals	A1
building an innovative culture	K02
modern programming languages	K01
business analysis	K02
development	K02
maintenance	K02
software improvement	K02
financial technology	K02
saas	K04
wealthtech	K02
azure	K02
.net	S1
asp.net-web-api	K02
powershell	K02
json.net	S1
financial technology	K02
saas	K04
wealthtech	K02
azure	K02
.net	S1
asp.net-web-api	K02
powershell	K02
json.net	S1
open for continuous change	S1
automation	K02
azure paas	S2
microservices	K02
.net	S1
powershell	K02
ms sql	S1
ci	K02
azure paas	S2
enhance and maintain ci infrastructure pipelines and azure paas environments	S2
ensure on-going health and stability of pipelines across multiple environments	S3
azure	K02
administrate and manage azure resources	S4
subscriptions	S2
resource groups	S1
devops	S2
GitHub	A1
support developers	K02
troubleshooting deployed applications	K04
identify app issues vs configuration/environment issues	S1
enhance quality through pipelines	S2
usage of static analysis tools	K04
SonarQube	K02
.net analyzers	K04
infer#	K04
creating and maintaining build and deployment pipelines for web applications and services	S1
azure appservice	S2
iis	S2
sql dbs	K04
azure appservice	S2
troubleshoot azure appservice hosted websites and services	S1
identify app issues vs configuration/environment issues	S1
.net	S1
automation	K02
powershell	K02
azure cli	K02
json	S1
yaml	K02
based templates	S1
AppServices	S1
redis	K04
ServiceBus	K02
api management	K04
CosmosDB	K02
KeyVault	K02
azure sql	S1
sql scripts	S1
azure devops ( cloud and server	S1
docker containers	K02
K8s	K01
english	L1
financial services	K02
java	K02
reactjs	A1
web-services	S1
financial services	K02
java	K02
reactjs	A1
web-services	S1
solving business problems	A1
innovation & engineering practices	S1
apply your depth of knowledge and expertise	K04
software development lifecycle	K02
partner continuously with your many stakeholders	S1
stay focused on common goals	S1
bs/ba degree	K01
application data and infrastructure architecture	K01
architecture	K02
design	K02
software systems	K02
developmental toolsets	K04
industry wide technology strategies and best practices	S1
work in a co-located team	S4
achieve organizational goals	A1
building an innovative culture	K02
software skills	K02
business analysis	K02
development	K02
maintenance	K02
software improvement	K02
deliver high quality products	S1
java/j2ee	K02
python	S1
go	S1
react	A1
cloud technologies	K02
AWS	S1
containers	K02
Kubernetes	K02
devops for platforms	S1
automated testing	K01
resource management	K04
artificial intelligence	K02
computer graphics	K02
software development	K02
python	S1
artificial intelligence	K02
computer graphics	K02
software development	K02
python	S1
build highly efficient accurate and scalable computer vision and machine learning services	K02
computer science	K01
solve technical challenges independently	A1
python	S1
english	L1
good communicator	S1
enjoy working in a team	A1
postgresql	K04
Django	K04
PostGIS	K04
opencv	K02
NumPy	K04
shapely	K02
pyhon multithreading and multiprocessing	K04
aws/azure	S2
computer vision	K02
machine learning	K01
e-commerce	S6
open-source	K02
ruby-on-rails	S2
sql	S1
heroku	A1
e-commerce	S6
open-source	K02
ruby-on-rails	S2
sql	S1
heroku	A1
gather technical requirements	K02
architect solutions	K02
estimate timelines	S2
deliver and further develop applications	S1
communicate	S1
investigate	K02
celebrate	K02
reward	A1
promote	S1
TDD	K02
agile delivery	S4
teamwork	A1
automated testing	K01
code reviews	K02
pair programming	K02
qa	S1
pm support	S1
staying in touch	S1
ruby on rails	S1
TDD	K02
deploy apps	S1
Heroku	A1
AWS	S1
sql	S1
english	L1
agile/scrum	K04
working with 3rd party api’s	K04
performed code reviews	K02
Docker	K04
spree commerce	S2
leading a team	A1
contributions to open source projects	K02
e-commerce	S6
ElasticSearch	K02
Kubernetes	K02
financial services	K02
reactjs	A1
cloud	K02
python	S1
financial services	K02
reactjs	A1
cloud	K02
python	S1
deliver initiatives	S1
modernizing and transforming the platform	K04
work on a mix of front-end back-end and cloud technologies	S1
running with a full stack development	K04
java	K02
python	S1
react js	S1
Redux	K02
public and private cloud offerings	S1
data warehousing/etl	K04
fixed income instruments	A1
reference data	K02
django	K04
postgresql	K04
redis	K04
django	K04
postgresql	K04
redis	K04
build software	K02
help our customers	S1
build and expand our predictive analytics platform	K02
work with a tightly knit team	A1
enterprise resource planning ( erp	K04
point-of-sales ( pos	S2
identify problems	A1
run experiments	K04
deploy promising solutions to production	K02
develop interfaces to erp and pos software providers	S1
etl	K06
work on etl pipelines	S2
integrate our customers data bases	S2
work closely together with our machine learning	S1
effective communication	S1
documentation	S1
writing software with emphasis on quality testability and automation	S1
backend development	K04
python	S1
linux administration	K02
Docker	K04
ansible	A1
git	A1
Pandas	K02
Celery	S2
django channels	K02
django rest framework	S1
redis	K04
Nginx	A1
gitlab ci	K04
postgresql	K04
english on level c1	K04
honest	A1
trustworthy	A1
communicates openly	S1
Cybersecurity	K02
data & analytics	S1
digital marketing	K02
powerbi	K01
dax	K04
cloud	K02
data-modeling	K01
azure-analysis-services	S2
Cybersecurity	K02
data & analytics	S1
digital marketing	K02
powerbi	K01
dax	K04
cloud	K02
data-modeling	K01
azure-analysis-services	S2
building front-end layer	K04
design and build front-end / bi layer	K02
power bi reports	S1
dax queries	K01
azure analysis services models	S2
troubleshoot issues	S1
recommend optimizations	A1
tune solution / reports for better performance	S1
scrum meetings	S1
sprint planning	K04
code reviews	K02
power bi	K02
DAX	K04
data modeling	K02
cloud	K02
CICD	K02
devops	S2
agile	K02
english	L1
bachelor's degree	K01
azure analysis services	K02
agile software development	K02
financial technology	K02
agile	K02
architecture	K02
agile software development	K02
financial technology	K02
agile	K02
architecture	K02
making the right decisions	S1
definition & communication of “fit for purpose”	S1
describing a solution architecture	K02
aligning the teams around the technical orientation	S4
connects with the teams	S4
evaluate the different technical alternatives	A1
continuous exploration and innovation	K02
delivery to business ( d2b	K04
service to deliver ( s2d	S4
work in delivery to business ( d2b ) or service to deliver ( s2d ) context	S1
creating business enabler art epics	S1
software/system design and architecture	K02
design	K02
modelling	K02
documentation	S1
solution architecture	K02
programming languages	K01
analyzing strategic objectives	K02
defining specific goals	S1
it or engineering bachelor / master degree	K01
scaled agile ( safe	A1
analytical and problem-solving skills	K01
networking	S1
communication	S1
persuasion	S2
ability to persuade others	S1
build and maintain positive and trustworthy relationships	S1
share knowledge	S1
engage in discussions and group decision-making	S1
presentation skills	S1
assertive	A1
pro-active	S2
personal efficiency	A1
financial technology	K02
c#	K02
f#	K04
typescript	K02
financial technology	K02
c#	K02
f#	K04
typescript	K02
modern workflows and tooling	K04
maintain quality	S1
work with aws infrastructure	S1
producing cloud native software	K02
continuous integration	S1
automated testing	K01
domain modelling	K02
ubiquitous language	S1
logging	S1
serverless containerisation	K02
dev/prod environment parity	K02
experimentation	S2
c#	K02
f#	K04
typescript	K02
serverless framework	S1
functional programming	K01
Cypress	S1
Jest	K02
Nunit	K04
SpecFlow	K02
Expecto	S2
FsCheck	S2
canopy	K02
functions as a service	S2
hosting	S1
messaging	S1
relational and non-relational databases	S1
Loggly	A1
c#	K02
f#	K04
typescript	K02
problem solver	S1
curious about new technology	S1
functional programming	K01
12-factor app approach	S1
build cloud	K02
takes ownership	A1
learn as much as possible	S1
good listener	S1
able to explain concepts	S1
committed to improving yourself	A1
demonstrate interest in technologies that are beyond the scope of your daily workflow	S1
lazy	S4
don't like boring repetitive tasks	A1
outsource your labour to the compiler	S4
applying yourself to learning	S1
pragmatist	A1
qa	S1
testing	K01
cypress	K02
mocha.js	K04
chai	K02
qa	S1
testing	K01
cypress	K02
mocha.js	K04
chai	K02
introduce and implement the newest standards and testing solutions/automation	K04
product creation	K02
build and provide access to test environments and new features	S1
responsible for a successful product launch	S1
bring expert knowledge	S1
define testing standards and strategies	S1
create detailed comprehensive and well-structured test plans and test cases	S4
design develop and execute automatic tests	S4
conduct exploratory/manual tests	K04
identify record document thoroughly and track bugs	A1
work closely with the product team	S4
make new features testable	A1
improve tickets	A1
update product information	K02
facilitate test environments access	A1
quality assurance	K02
software qa methodologies tools and processes	S1
automated testing tools	K01
Cypress	S1
pytest	A1
truffle	K04
solidity	K02
coding/scripting	K04
devops	S2
build test environments	K02
CircleCI	K02
Docker	K04
work in an agile & energetic startup environment	A1
english	L1
collaboration tools	S1
computer software	K02
open-source	K02
testing	K01
qa	S1
automation	K02
software-quality	K02
automated-tests	S2
collaboration tools	S1
computer software	K02
open-source	K02
testing	K01
qa	S1
automation	K02
software-quality	K02
automated-tests	S2
ensuring high quality for customer-specific software projects	S1
analysis and risk assessment	S3
creation maintenance execution and documentation of ( automated ) tests	S3
collaboration in project teams	S1
communication with technical customer departments	S1
active support of our development and operations teams	S4
creation analysis and processing of error reports	S3
computer science	K01
agile approaches to software testing and development	S1
tools procedures and programming languages for test automation	K01
familiarize yourself with new technologies	S1
contribute innovations	S1
handling and understanding of web-based applications apis	S1
good eye for details user expectations and potential sources of error	S1
structured and result-oriented way of working	K04
willingness to learn	S1
joy of communication	S1
independent cooperation	S1
team skills	A1
social competence	S1
german	L1
english	L1
financial services	K02
financial services	K02
solving business problems	A1
innovation and engineering practices	S1
apply your depth of knowledge and expertise	K04
partner continuously with your many stakeholders	S1
stay focused on common goals	S1
bs/ba degree	K01
application	K01
data	K01
infrastructure architecture disciplines	K02
architecture and design	K02
programming languages	K01
industry-wide technology trends and best practices	S1
financial control	K02
budget management	K04
work in large collaborative teams	S1
achieve organizational goals	A1
building an innovative culture	K02
r	K04
java	K02
nosql	A1
r	K04
java	K02
nosql	A1
solving business problems	A1
innovation & engineering practices	S1
apply your depth of knowledge and expertise	K04
partner continuously with your many stakeholders	S1
focused on common goals	S1
energetic	A1
intelligent	K02
self-starter	S2
java	K02
rest/web services	S1
r	K04
pentaho	K04
oracle	S2
nosql	A1
agile	K02
application process management	K01
monitoring platforms	K01
streamlining integration	S1
issue tracking	K04
deployment	K04
change management	K02
communicate advanced technical design and solutions	S1
work collaboratively in teams	S1
develop meaningful relationships	S1
achieve common goals	S1
application data and infrastructure architecture & design disciplines	K02
analyse requirements	S2
interact directly with business users	S1
cloud micro-service and container deployment patterns	K02
testing	K01
ci	K02
behaviour driven development skills	S1
work in large collaborative teams	S1
achieve organizational goals	A1
building an innovative culture	K02
java	K02
r	K04
databases	K03
etl tools	K04
r	K04
python	S1
machine learning	K01
data tables	K01
Qpid/MQ/Kafka/RabbitMQ	K04
big	K02
financial performance calculations	K01
calculating benchmark blends	S2
entertainment	K02
gaming	K02
mobile game	K02
unity3d	K02
c#	K02
user-experience	S1
entertainment	K02
gaming	K02
mobile game	K02
unity3d	K02
c#	K02
user-experience	S1
flair for gameplay	S4
aesthetic know-how?	S1
work closely with other programmers designers and artists	S1
implementing and maintaining various platforms and systems	S1
unity	K04
mobile game development	K02
unity3d	K02
c#	K02
unity	K04
implement new game features	S1
making the designs look final and pretty	K02
self-driven	A1
open-minded	S1
not afraid to be critical	S1
collaborate with your colleagues	S1
find solutions	S1
implementing new gameplay features and user interfaces	S1
contributing to and maintaining existing game features	A1
participating in the development of new features and optimizing existing ones	S2
participating in the development of performant and rigid systems	K04
running tests on new code	K04
mobile games	S1
unity3d ( ios and/or android	K04
c#	K02
ux	S2
making user experiences at an interactive degree	S1
3d game programming	K04
math	K05
dynamic skills	K04
aesthetic know-how	A1
system and architectural thinking	K02
developing mobile games with a large amount of content delivery	S1
sense of f2p game design	K02
tdd ( test driven development	K01
objective c	K02
java	K02
computer software	K02
databases	K03
information technology	K02
java	K02
algorithm	K05
database	K02
multithreading	K04
concurrency	S1
computer software	K02
databases	K03
