questioning	K04
expressing self clearly and	S1
seek develop and secure new opportunities	S1
measure monitor and review performance of key accounts	S4
ensuring budgets and forecasts are met	S4
identify and monitor key performance and financial indicators	S4
maintain and monitor service expectations of existing and key accounts	S4
support external sales force	S1
management of business	S4
select appropriate carrier	S4
maximise freight profits	S4
manage your own time	A1
integrate and co-ordinate new business	S1
arrange regular meetings	S1
submit financial reports	S1
CIMA	K09
care deeply	A1
ever-changing environment	S4
excel	K05
shape the world of iot	S1
advocate quality	S4
verify	S4
validate	S4
analyze	A1
lower risks	S1
automate tests	S4
build great products	S4
shape the features	S1
cloud-based microservices	S4
audio/video pipelines	S4
machine learning	K09
mobile applications	S4
critical thinker	S1
user experience	S1
quality	K04
software testing	K04
curiosity	K09
resourcefulness	K09
find problems	S1
provide creative solutions	S4
software testing techniques	S4
advocate for quality in decision making	S4
tinkerer	A1
create your own apps and robots	S4
working closely with developers	S1
diligent with documenting your test plans test cases bug reports	S1
coding	K04
python	K05
java	K02
javascript	K02
Golang	K01
selenium	K09
TestCafe	K02
web	K02
api	K09
backend	K04
integration	S1
performance/load/stress	A1
security testing	K04
continuous integration	S4
continuous delivery and/or deployment	S4
jenkins	A1
CircleCI	A1
linux	K02
Docker	A1
Kubernetes	K02
web services	K02
networking	S1
distributed systems	S4
cloud services	K02
GraphQL	K02
driving?	K10
fast-paced team environment?	S1
upholding a positive brand image	A1
providing excellent customer service	S4
managing cash and card transactions	S1
delivering products safely and securely	S1
avoiding unnecessary risks	S4
safety and security procedures	S3
uk or eu driving license	S4
own car	A1
local area	S4
fast-paced environment	S3
customer service	S4
quality	K04
driving!	S4
food hygiene	K01
store cleanliness	A1
keen eye for detail	S1
day to day running of kitchen ordering and installs	S1
work closely with our installation team	S1
deliver projects efficiently	A1
maintain an impeccable level of customer service	S3
joinery	A1
kitchen industry!	A1
email	K02
organisational skills	S1
self-motivated	A1
working on their own initiative	S4
communicator	K04
kitchen industry	K01
computers	K02
attention to detail	S4
building and maintaining strong relationships	S4
multi-task	S1
deliver against deadlines	A1
valid uk driving license	A1
communication skills	S1
kitchen industry	K01
valid uk driving licence	A1
a-level	S3
support the bakery management team	S4
support the teams	S1
go above and beyond for our customers	S1
positive	A1
energetic	A1
engaging with people	S1
communications skills	S1
talented	A1
fun	K02
ambitious	A1
provide first line support to our team of colleagues	S4
reporting directly to the head of team experience	S1
overseeing hr administration	S4
maintaining hr records	S4
compiling hr data	S4
running reports	K04
managing hr processes	S4
hr best practices	S1
processes	S1
policies	K04
employment law	S4
organisation	S4
attention to detail	S4
positive	A1
professional	A1
communication	S1
literacy	K01
numeracy	K04
it skills	S1
willingness to develop	S1
line management	K04
level 5 cipd	S4
Kronos	A1
maximising sales	K04
building a highly engaged and high performing team	A1
leading from the front	S4
hands-on approach	S1
inspire your team	S4
inject fun into the work place	S1
create a truly amazing place to work	A1
delivers an exceptional standard of customer service	A1
pet knowledge	A1
deliver the highest standards of pet care	S1
ensure that the welfare of pets is a top priority	S3
promoting responsible pet ownership	S4
motivating training and developing your team	S4
running a store	S4
achieving and exceeding key store targets	S4
communicate effectively to your team	A1
take full responsibility for the store	A1
involved in absolutely everything in your store	S1
recruitment	K04
stock control	K02
store standards	A1
retail	K01
pets!	A1
supervisory/management	S4
hands-on approach	S1
delivering high standards!	S1
people person	A1
team player	A1
communication	S1
engage and inspire a team	A1
proactive	A1
customer focused	S1
recording of events and service failures	S4
chasing and completion of calls	S4
production of work request failures	S4
liaising with internal team and external contractors	S4
maintenance of records of live and paid works	S3
kpi's	S4
SLA's	S4
raising purchase orders	S4
completion of worksheet upload spreadsheet	S1
cafm system administration	S4
assisting the helpdesk manager	S4
general office administration duties	S1
reporting	K04
provide minutes of meetings	S4
contract administration	K04
ensure the helpdesk operates professionally	S4
manage the lines of communication	S1
achieve a high degree of customer and supplier satisfaction	S1
achieving key performance indicators ( kpis	S4
customer service	S4
system knowledge	S1
operate a helpdesk function across multiple sites	S4
accurately record details of the caller problem and severity	S4
ensure that the service centre manager is aware of situations which could develop into issues	S4
work within and to processes and procedures	S1
respond quickly and efficiently to all requests	S1
attention to detail	S4
obtaining and inputting information	S2
clear and professional telephone manner	A1
achieve a high degree of customer and supplier satisfaction	S1
applying logic and common sense	S1
ensuring that identified criteria are escalated	S1
scheduling ppm remedial and reactive work	S1
jeopardy management	S4
escalation of planned and responsive works	K04
monitor and optimise the utilisation of engineer activities	S4
scheduling of works	S4
raising purchase orders	S4
run reports	S1
show outstanding work orders	S1
attend training and coaching sessions	S3
identify any potential areas of improvement	S4
flexible	A1
adaptable	A1
highlight any training needs and development	S1
operating a facilities management helpdesk	S4
call centre service	S4
developing productive working relationships	S1
qfm helpdesk system	S4
computer hardware	K02
peripherals	K09
applications	S4
networks	K02
shared files and folders	S4
report creation	K04
keyboard skills	S1
focusing on client & customer	S4
delivering stretched results	S1
act collaboratively	A1
intellectual agility	K04
willingness to learn	S1
computer databases	S1
nvq level 2 or 3	S1
customer service	S4
call handling	S1
working with and developing kpiâ€™s and measurement information	S4
rsa level i keyboard skills	S1
european computer driving licence ( ecdl ) level i	S1
microsoft word	A1
microsoft excel	A1
level 2 & 3 nursery	S3
providing care and educational support	S4
pms	K09
reservation systems	A1
customer service?	K10
organised analytical approach	S1
numerical skills	S1
pms	K09
reservation systems	A1
timekeeping	A1
work calmly in a high-pressure environment	S1
english	K02
making reservations	S4
ensuring that all enquiries receive a prompt response	S4
all correspondence is accurately filed	S1
log failures	K09
convert a booking	S4
monitor non-arrivals and late cancellations	S4
run daily arrival checks	S4
ensure all reservations are correct	S4
work with others	S1
improve our customer service	S4
cover reception	A1
monitoring and recording key data	S4
keeping the pms up-to-date	A1
ensure that market segmentation rates and guest information are accurately recorded	S1
helping the hotel to achieve its financial targets	S4
upsell	A1
escalate/communicate about any new sales leads	S4
contribute to pricing decisions	S4
highlighting if availability is changing	S1
rate strategies should be reviewed	S4
pms	K09
reservation systems	A1
organised	K01
analytical	K04
customer service	S4
commercial awareness	S4
corporate tax	K01
personal tax	K09
vat	K02
ACCA/ACA/ATT	S4
cta	S4
supporting and training the more junior member of staff	S4
manging	K01
supervising	S3
coaching	S1
mentoring	K01
work with a varied portfolio	S1
provide compliance and advisory services	S4
support clients	S4
services in corporation tax and personal tax	S1
work in a varied capacity	A1
confident	A1
professional	A1
ambitious	A1
tax planning	K01
advisory work	A1
tax computations and reviews	S1
capital gains tax	K10
trusts	S1
inheritance tax/wills	S1
property tax	K01
corporate tax planning	K01
mergers & acquisitions	S4
restructuring	K04
investments	K09
dealing with a variety of high net worth individuals partnerships directors tax omb	S1
manage the team	A1
planning and reviewing work in progress	S4
supporting the directors	S4
providing direction to the team	S4
lead and grow the department	S1
business development	K04
selling services	S1
CIMA	K09
help residents enjoy each day	S1
assist with daily living	S4
providing support and companionship	S4
dedication	A1
compassion	K01
supporting residents with their food and drink	S4
following care plans	S1
caring for older people	S4
can-do approach	S1
communication skills	S1
empathy	A1
warm-hearted approach	S1
compassion	K01
deliver the highest standard of care and support	S1
drive expansion	S4
exceed monthly / quarterly sales targets	S1
driving new opportunities	S4
exceed monthly / quarterly sales targets	S1
driving new opportunities	S4
analyse your industry territory	S1
identify prioritise and segment accounts	S4
collaborating	K09
create demand	S4
cold calling	S1
email / social campaigns	S1
supporting other business development activities	S4
engage your extended team	S1
engage with prospect organisations	S4
strategic value-based selling	S1
business case definition	K04
return on investment analysis	S1
references	S1
analyst data	K09
engage with customer cios and cfos	S1
converse with senior technologists	S4
generate short term results	S1
maintaining a long term perspective	S4
maximize overall revenue generation	S4
provide accurate monthly forecasting and revenue delivery	S4
build and maintain a territory pipeline of business	S4
selling enterprise software	K04
PaaS	S1
IaaS	K01
saas	S1
net direct new business sales	S4
consistent delivery against targets	S1
strong customer care	S4
helping to ensure customer success	S4
credibility	A1
building strong relationships internally and with the customer	S1
selling industry-specific use cases / technologies	S4
CPG	S4
manufacturing	K04
services	K02
iPaaS	K01
api management	K04
automation	K09
bpm	S4
deliver key business outcomes	S1
bachelorâ€™s degree	K01
full driving license	S4
internal framing work	S1
finishing work	A1
skirtings	K02
facings	K09
cscs card	S3
carpentry	A1
CSCS	K01
electro/mechanical assembly	S1
hand assembly	S1
wiring electronic sub-assemblies	S4
mechanical assembly	S1
working to customer specifications	S1
can do attitude	A1
driving	S4
strategic planning & governance	S4
strategic planning	S4
performance reporting	K04
strategic planning	S4
corporate performance	S4
manage the strategic planning and corporate performance reporting functions	S4
manage the strategic and operational planning process	S4
support senior colleagues	S4
completing plans	S4
provide specialist advice	S4
guidance	K10
support to managers staff and the public	S1
strategic planning	S4
corporate performance	S4
conduct stakeholder consultation/engagement	S4
engage with internal and external groups and networks	S1
development or expansion of good practice	S1
strategic planning	S4
corporate performance	S4
coordinate the preparation of an annual report	S4
ensure the annual report complies with the government financial reporting manual ( frem	S1
government financial reporting manual ( frem	S1
analytical decision making	K04
communication skills	S1
maintain positive relationships	S1
seek information and co-operation	S1
conduct trend analysis on complex data sets	S4
working with stakeholders	S1
inform of any discrepancies variances and trends	S1
scqf level 9	K02
technology	K02
project manage	K04
bridge the gap	A1
liaising with many stake holders	S4
influencing and negotiation skills	S1
prince2 practitioner qualification	S1
msp qualification	S4
project management	K04
change management	K04
benefit realisation	S1
workforce redesign	K04
energetic	A1
work independently as well as in a team	A1
persistent	A1
sales	S1
B2B	S4
concept sales	S4
business	K02
english	K02
french	A1
german	K02
java	K02
working in the web layer	S1
working as a key member of an agile team	S4
frequent delivery	S1
end-to-end application ownership	S1
contributing to a cross functional agile team	S4
elaboration development and testing of user storiesÂ•	K04
sprint planning	A1
backlog grooming	K04
task estimationÂ•	K04
development and modification of frameworks common components and business componentsÂ•	S4
development of unit tests	S4
contribution to the creation of automation in higher levels of the test pyramidÂ•	S4
refactoring code	K04
contribution to code quality improvementsÂ•	S4
development standards	S1
best practices	S1
software development	K04
review of colleagueÂ’s codeÂ•	S1
progressive development behaviours	S1
maximizing collaboration	S1
knowledge sharing	S1
effective pairing	A1
creation of pocÂ’s / spike development	S4
involvement in technology evaluation	S1
work and communicate across geographical and cultural borders	S1
build a strong professional network	S4
participation in the elaboration of user stories	S1
agree stories are sufficiently described	S1
quality design and implementation	S4
ensuring builds are kept green	S4
code management strategy ( branching ) is closely	S1
raising capability and standards	K04
pairing on tasks	S4
peer review of team membersÂ’ code	S1
constructive feedback for improvement	K04
proactive contribution to continual improvements	S4
active participation in retrospectives	K09
engagement with cross team bestpractice	S1
support product owner	S4
identify and manage risks debt issues and opportunities	S4
support the recruitment activities	S4
technical support	S4
technical support	S4
implementation skills	S1
java	K02
SpringBoot	A1
unit testing	K04
development	K02
agile	A1
integration of testing into development workflow	S1
test frameworksÂ• build tooling	S1
maven)Â•	K02
work in ui	S1
continual delivery pipeline tools	S1
jenkins	A1
ansible	A1
communication skills	S1
articulate clearly to technical team members	S1
work with product owners	S4
collaborative	K09
critical reasoning	K04
problem solving	A1
agile software development	S1
xp	K01
BDD	K01
TDD	K01
fast turnaround development	A1
continuous delivery	S1
service orientated	A1
microservice architectureÂ•	S4
shared-nothing architecture	S1
domain driven design	K04
bounded contextÂ•	S1
high volume transactional systemsÂ•	S3
api gateway	K01
Akana	K09
coherent software architecture and designÂ•	S4
message or event based architecturesÂ•	S1
eventual consistency concepts	K04
contributor to open source projects	S1
mechanical understanding	S1
automation	K09
process optimization	K04
support and problem-solving	S4
decanters	A1
high-speed separators	S4
putting put the customer first	S4
preventive maintenance of supplied equipment and machines	S4
repair and service according to customer requirements	S1
support to customers	S4
general technical support	S4
adjustments to equipment and machines	S1
start-up and commissioning of machinery	S4
process plants on board vessels	S1
training of the crew	S4
optimization of plant and equipment	S1
decanters	A1
high-speed separators	S4
PureBilge	A1
FWG	L1
pure	K09
marine business	K09
sailing	S4
mechanical understanding	S1
automation	K09
control systems	S4
microsoft office	A1
danish	K02
english	K02
developing our new data backbone	S4
inspiring the stakeholders	S4
advanced analytics	K04
artificial intelligence	K04
extracting insights and value from data	S4
applying domain expertise	S1
ensure data collection procedures	S1
building analytic systems	K04
operationalise data mining and analysis into business applications	S1
maintain the productionised models	S4
quantitative or data-heavy functions	S4
c#	A1
python	K05
java	K02
open source data ingestion tools	S1
nifi	K01
cloud platforms	K02
container technology tools	S4
analytics engines	K04
spark	K02
Databricks	K02
data visualisation tools	S1
cloud platforms	K02
machine learning	K09
algorithms	K04
willingness to learn	S1
criminal record certificate	S1
criminal record certificate	S1
criminal record certificate	S1
registering and controlling goods	S4
picking and packing	S4
preparing pallets	S4
loading and unloading lorries	K04
operating a forklift	S4
forklift license	S4
independently	A1
proactively	A1
set high standards	A1
flexible	A1
helpful	K02
developing and applying new optical microscopy techniques	S4
intestine	S4
biopharmaceuticals	K09
reinvent our research strategies	S4
constructing a 'light sheet' fluorescence microscope	S4
live-sample imaging	S1
3d printed organoids	K09
pursue a deeper understanding	S1
implementing one of the worlds most advanced optical microscopes	S4
use the microscope	S1
capture how fluorescently labelled biopharmaceuticals travel through the intestinal barrier	S1
optimizing microscope hardware and software	S4
provide the best images	S4
drive hardware/software development	S4
document present and publish scientific findings	S1
contribute to the enjoyable and collaborative work environment	S1
master's degree	K01
work independently	A1
prioritize tasks	S4
plan and execute complex hardware implementation	S4
interface optics	S1
electronics	K10
software	K02
work constructively in a team	S1
analyse	K09
contribute	S4
solve biological/mathematical challenges	S1
use software for instrument control	S1
labview	K01
use software for data simulation	S1
basic image analysis	K04
matlab	K02
use software for basic mechanical design	S1
SOLIDWORKS	K02
communicate professionally	A1
english	K02
present insights progress and bottlenecks	S4
european code of conduct for research integrity	S1
software/hardware development	S1
fundamental biology/physiology	K09
bsc/msc diploma	S4
research	K04
teaching	K04
marketingÂ—in	S4
business	K02
development	K02
active engagement	A1
strengthen the relationship	S1
initiate and participate in external funding	S1
sustained record of research publications	S1
research management	K04
teaching	K04
provide dynamic leadership	S4
teaching	K04
research dissemination	K04
working with business and society	S1
undertaking research	S4
teaching practice	K04
dissemination	K09
business research	K04
research management	K04
initiation of research projects	S4
supervision of ph.d	S1
international research co-operation	K09
journal editorship	S1
reviewing for academic journals	S4
academic development	A1
marketing	K02
research-based teaching	S1
supervision	S3
examination	K09
teaching on business research	K04
course and program development	K04
promotion	S2
participation in and possibly initiation of externally funded research projects	S3
contribution to the administrative responsibilities	S4
dissemination of research findings	S1
participation in the departmentÂ’s regular research activities	S1
engagement in and contribution to academic citizenship activities	S1
participate actively in the research and teaching activities	S1
maintain and establish broad links	S4
record of research	K01
teaching	K04
research management	K04
research	K04
teaching	K04
business research	K04
provide dynamic leadership	S4
development of research	K04
teaching	K04
research dissemination	K04
working with business and society	S1
achieving ) research grants	S4
pedagogical qualifications	S1
development and innovation in the pedagogical area	S4
english	K02
teaching qualifications	K04
teaching evaluations	K04
love being outdoors	S1
create an entertaining & memorable tour	S4
share your knowledge?	S1
responsible and professional work ethic?	A1
providing fun informative and engaging tours	S4
know all information provided	S1
run tours on time	S1
provide extensive information about the city	S4
answering customer questions	S4
show independent thinking	S1
professonal approach	S1
leadership	S4
assiting with teambuilding excercises	S4
leading	K04
meticulous	K09
detail-oriented	S1
ensure the shop is tidy and clean	A1
dusting	K01
vacuuming	K09
set up for your customers	S1
independent work approach	K04
street-marketing	K04
street-marketing	K04
approaching people	S4
confident	A1
engaging	K04
english	K02
german	K02
danish	K02
lively	A1
fun	K02
public speaking	K04
engage an audience	S1
responsible	A1
dutiful	A1
mature	K02
demonstrate leadership abilities	S1
service-minded	A1
providing a first-class experience	A1
perform at your best ability	S1
high-school diploma	K01
bachelor/post-graduate degree	K01
danish	K02
english	K02
service-industry	A1
tourism	K09
social media marketing	K04
sales	S1
Segways	A1
first-aid skills	S1
stamina	K09
love for being outdoors	S1
supply chain	S4
manage challenges	A1
business acumen	S4
planning skills	S1
collaborating	K09
ensure reliable supply	S1
operating in a structured formal monthly sales and operations planning process	S4
sales and operations planning process	S4
maximize product availability	S4
standardized global processes	S4
sap	K02
optimize supply and inventory plans	S1
lead supply scenario analysis	S1
monitor supply and capacity performance	S4
coordinate supply and capacity bottleneck management	S4
support the supply risk management process	S4
respond to ad hoc requests	S1
establish and develop a close collaboration	S1
planning	K04
masterÂ’s degree	K01
business	K02
engineering	K04
supply chain management	S4
supply chain	S4
sap apo	K02
providing ideas and input for optimization	S4
handle hands-on planning tasks	S4
complex coordination	S4
overview	K04
sense of detail	S1
open-minded	A1
establish collaborative relations to people	S1
tailor your communication to your audience	S1
make people prioritize your agenda	S4
advanced electron microscopy	A1
environmental catalysis	K01
nanomaterials	K09
selective catalytic reduction ( scr ) of nox	S1
undertake atomic-scale studies	S1
situ transmission electron microscopy	K09
characterization tools	S1
surface science techniques	K01
catalyst testing	S2
synthesis	A1
develop an understanding of the catalytic performances	S4
target new designs of catalyst materials	S1
improving nox emission control	A1
experimental research	K01
scr catalysts	A1
application of s/tem and eels for atomic-resolution and in situ studies	S1
develop our atomic-scale model	S1
scr	S4
scr catalysis	K01
publishing in high-profile journals	S1
committed	A1
flexible	A1
innovative mind-set	A1
new ideas	S1
ready to face new challenges	S1
take responsibility	A1
execute and communicate complex research goals	S4
enthusiastic	A1
catalysis sciences	A1
Ph.D	K01
physics	K09
chemistry	K09
high-resolution ( scanning ) transmission electron microscopy ( s/tem	S1
heterogeneous catalysts	K09
solid-state nanomaterials	S4
audio engineering	S4
acoustic design	K02
algorithm trimming	K04
sound quality evaluation	K04
passion	K02
creativity	K04
work on new algorithm concepts	S1
directionality/beam-forming	S4
trimming and verification of various audio algorithms	S4
audio engineering	S4
msc	K01
outgoing	K10
getting things to move forward	S1
inspires your colleagues	S1
dealing with many stakeholders	S4
setting a direction	S4
english	K02
audio engineering	S4
algorithm concepting	K04
directionality	K04
beam-forming	S4
matlab	K02
python	K05
trimming of various audio algorithms	S1
noise reduction systems	S4
eq	K02
compressors	K09
objective and subjective sound quality evaluation	S1
measurement systems for audio evaluation	S1
soundcheck	K09
head acoustics acqua audio analyzers	S4
communicating technical issues	S4
research the market	S1
take initial contact to potential clients	S1
carry out market research of potential clients	S4
establish initial contact to potential clients	S1
translate sales material	S1
english	K02
italian	K01
italian	K01
english	K02
tele marketing	K04
proactive on the phone	A1
independent	A1
positive	A1
proactive	A1
danish	K02
working in a sales department	S1
leading technology strategy roadmaps and transformation plans	S4
communication	S1
integration	S1
PLM/PDM	S4
manufacturing execution	K04
product quality systems ( qsys	S4
global erp ( sap ) platforms	S4
dynamic	A1
personal motivation	S1
drive	A1
approach complex tasks	S1
open mind	A1
focus	K02
providing the best solution	S4
structured	K04
analytic	A1
lead the technology roadmap	S4
participate actively in strategic projects	S1
PLM	K01
main interface between plm data and systems governance organizations	S1
lead and coach a team	S4
PLM	K01
model and control enterprise plm architecture ( data and systems	S4
TOGAF	K01
asses value propositions of project proposals	S1
Teamcenter	S1
PLM	K01
how systems interact with erp	S1
manufacturing execution systems	S4
PLM	K01
erp systems	S4
capturing requirements from large organizations	S4
architecting value creating solutions for the business	S4
enabling the software to create value	S1
processes	S1
lifecycles	A1
wind turbine	K10
communicate on all levels	S1
persuasive communicator	S1
english	K02
teaching	K04
research	K04
basic and applied nutrition of ruminants	S3
dairy cattle	S1
dairy production	S4
data modelling	K04
evaluation of feed quality and feed intake in dairy cattle	S1
nordic feed evaluation system	S1
NorFor	S1
dairymanagement system	S1
feed evaluation	K04
digestive processes	S1
intermediary metabolism	K09
impact of nutrition and feeding management	S1
animal health	K09
product quality	S4
research	K04
publication/academic dissemination	S1
research-based teaching	S1
examination	K09
sharing knowledge with society	S1
phd degree	K01
research	K04
teaching	K04
enterprising	K04
interpersonal skills	S1
information technology	S1
java	K02
algorithm	K09
database	K02
multithreading	K01
concurrency	A1
solve technical challenges	S4
deliver high quality code	S1
build and ship new features	S4
write high quality testable and efficient code	A1
promote new ideas	S4
take active part in features discussions and roadmap prioritisation	S1
integrate cutting edge research and technologies	S1
work closely with our customers and other teams	S1
developing production level software	S4
designing multi-threaded systems and algorithms	S4
system design	K02
data structures	S4
algorithms	K04
java	K02
troubleshooting	S4
performance profiling	S4
optimisation	K04
development methodologies	K04
care about code quality	A1
communication skills	S1
sense of humor!	A1
eCommerce	S4
price comparison	S4
online portal	K09
.net	K02
agile	A1
rest	K02
microservices	S4
eCommerce	S4
price comparison	S4
online portal	K09
.net	K02
agile	A1
rest	K02
microservices	S4
development test and deployment of new components	S4
transition	K04
re-engineering	K04
design	K02
extension	K02
continuous integration	S4
continuous deployment	S4
.net	K02
micro services	A1
development and implementation of rest api's	S4
web and/or e-commerce	S1
agile method practice	S1
english	K02
german	K02
data science	K01
it security	A1
software development / engineering	S4
java	K02
rest	K02
cloud	K02
spring	K02
design-patterns	S1
data science	K01
it security	A1
software development / engineering	S4
java	K02
rest	K02
cloud	K02
spring	K02
design-patterns	S1
enthusiasm	A1
professional attitude	A1
work together closely with product owners and colleagues	S1
develop an in-depth understanding of the domains and the requirements	S4
happy to share your valuable insights	S1
offer them professional advice	S4
share your knowledge	S1
advise individual colleagues	S3
software development	K04
agile project team	S4
java stack frameworks	S4
quality	K04
testing at various levels in an agile environment	S4
test automation	K09
clear easy-to-maintain code	A1
latest technologies	S4
back end development	S1
databases	K02
cloud computing	S4
restful api	S1
big data	K09
devops	K04
build implement and operate a system	S4
architecture concepts	S4
design patterns	K02
german	K02
english	K02
digital agency	S1
software development / engineering	S4
user experience	S1
javascript	K02
angular	K02
reactjs	A1
vue.js	S1
typescript	K02
digital agency	S1
software development / engineering	S4
user experience	S1
javascript	K02
angular	K02
reactjs	A1
vue.js	S1
typescript	K02
develop attractive state-of-the-art user interfaces	S1
application architecture	S4
api design	K02
implementation of functionality	S4
code reviews	S7
technical advice for our customers	S4
guidance and support for your teammates	S1
realize exciting projects	S1
degree in computer science	K01
javascript/typescript	K04
angular	K02
react	A1
vue	K09
architecture of complex single page applications	S1
accessibility	A1
usability	K04
current web standards	S1
code quality	K04
clean code	A1
quality and responsibility	A1
eye for aesthetics design	S1
faithful implementation	S1
german	K02
english	K02
financial services	K10
financial technology	K10
regulatory reporting	K04
c#	A1
typescript	K02
.net-core	S4
less	K02
sql-server	S3
financial services	K10
financial technology	K10
regulatory reporting	K04
c#	A1
typescript	K02
.net-core	S4
less	K02
sql-server	S3
deliver software solutions	S1
creation of programs	S4
configuration/customisation of platforms	S4
capture & analysis of requirements	S4
requirements capture/analysis and documentation	S4
design ( and documenting ) of own solutions	S4
writing software	K04
configuring software platforms	K04
troubleshooting	S4
debugging code	K04
testing	K04
analysis of test results	S1
documentation	K04
microsoft	K02
web development	K04
c#	A1
.net core	K02
.net framework	S1
sql	K02
sql server	K04
typescript	K02
javascript	K02
asp.net	S1
Blazor	K02
javascript	K02
JQuery	K04
angular	K02
react	A1
vue	K09
html5	K02
css ( less	S1
Bootstrap	K04
troubleshooting it infrastructure related issues	S4
microsoft-based development environment	S1
microsoft certifications	S4
team player	A1
methodical and reliable approach	S1
problem solving	A1
financial services	K10
communication skills	S1
java	K02
testing	K04
web-services	S1
java	K02
testing	K04
web-services	S1
solving business problems	S1
innovation & engineering practices	S4
apply your depth of knowledge and expertise	S1
software development lifecycle	K04
partner continuously with your many stakeholders	S1
stay focused on common goals	S1
creating api services	K04
work closely with colleagues and the business	S1
functional and non-functional requirements	S4
drive the design and implementation of well tested easily supportable scalable and robust solutions	S4
bs/ba degree	K01
deployment approaches	S4
considerations	K04
managing deployments	S4
industry wide technology strategies	S4
best practices	S1
work in large collaborative teams	S1
achieve organizational goals	S1
building an innovative culture	S4
java ( version 8 or higher	S4
spring boot	S1
performance testing	K04
unit testing	K04
integration testing	K04
behavioural testing frameworks	S1
mocking frameworks	K04
continuous integration	S4
designing applications	S4
high throughput mission critical high performance stp platforms	S4
designing and building reusable services	S4
support the developers in your team	S4
leading	K04
supporting	S4
coaching	S1
application delivery	S1
stakeholder management	K04
oracle	A1
cloud services	K02
information technology	S1
technology consulting	K04
.net	K02
microsoft-dynamics	S4
dynamics-365	S4
cloud services	K02
information technology	S1
technology consulting	K04
.net	K02
microsoft-dynamics	S4
dynamics-365	S4
developing	K04
development	K02
customisation	K04
configuration	K04
development of plug-ins	S4
c#	A1
work with business product owners and business analysts	S4
elicit requirements	S4
assist in developing design specifications	S4
maximise the benefit	S1
collaborate with other stakeholders/ end users	S1
software development lifecycle	K04
design	K02
development	K02
delivery	S1
dynamics 365	S4
dynamics crm	K09
dynamics 365	S4
.net	K02
ms dynamics 365	S4
technical aptitude	K01
providing extraordinary customer service influence impact	S1
problem-solving	A1
building customer and partner relationships	S4
microsoft stack	S4
dynamics 365	S4
scrum/agile	S4
sc clearance eligible	S1
.net webapi	K02
sharepoint	K09
vehicle tracking	K04
azure	S4
.net	K02
c#	A1
azure-cosmosdb	S4
rest	K02
vehicle tracking	K04
azure	S4
.net	K02
c#	A1
azure-cosmosdb	S4
rest	K02
development cycle	K04
analyzing	A1
deciding the best approach	S4
write code	K04
design patterns	K02
unit tests	K09
design	K02
write code	K04
.net	K02
modify .net services and apis	S1
apis	K09
maintain strong backend code quality	S4
c#	A1
.net framework	S1
.net core	K02
t-sql ( ms sql server	S1
object-oriented design	S1
restful services	S1
azure storage	K04
azure eventhub	K04
azure functions	K04
azure data lake	S4
azure cosmosdb	K04
security principles	S4
computer science	K05
engineering	K04
teamwork	A1
attention to detail	S4
resourceful	K09
problem solving	A1
communication skills	S1
english	K02
qa	K01
automation	K09
testing	K04
qa	K01
automation	K09
testing	K04
delivering real quality	S1
planning test activities for each build cycle	S4
testing client configurations	S4
reporting the results	S4
incorporating that testing into automation	S4
reporting and documenting issues found	S4
following up on issues raised	S4
communicator	K04
connect together complex issues	S1
appreciate quality	S1
testing	K04
automation	K09
complex system	K01
code	K02
financial services	K10
qa	K01
python	K05
automation	K09
financial services	K10
qa	K01
python	K05
automation	K09
automation	K09
functional testing	K04
regression/reconciliation	K09
new feature testing	S1
continuous delivery	S1
end to end automated testing	S1
data integrity	S1
performance	K09
presentation quality	K04
software development	K04
automate end to end test requirements	S1
java/python	S1
schedule and execute regression cycles	S3
execution of non-functional regression testing	S1
ensure the resiliency and performance of the system	S4
operational processes	S4
provide solutions	S4
improve operational efficiency	S4
agile	A1
participating in sprint planning backlog refinement	A1
retrospectives	S4
defect management	K04
of test coverage	S1
identify gaps	S4
provide improvements	S4
it/quality assurance	S4
bachelor's degree	K01
computer science	K05
quality assurance	S4
testing arena	S4
quality assurance methods/processes	S4
lifecycle principles	S4
quality assurance processes	S4
automated testing	K01
java	K02
python	K05
testing of mainframe	S4
test automation frameworks	S4
communicate	S1
work under pressure	A1
resolve issues affecting the production services	S4
detail oriented	S1
work independently	A1
core java	K02
unix scripting	S4
sql	K02
continuous integration ( ci	S1
git	K01
jenkins	A1
mainframe/ibm iseries	S4
iseries menu/end of day	A1
read/publish on message	S1
financial services	K10
cloud	K02
java	K02
amazon-web-services	S4
financial services	K10
cloud	K02
java	K02
amazon-web-services	S4
solving business problems	S1
innovation and engineering practices	S4
apply your depth of knowledge and expertise	S1
software development lifecycle	K04
partner continuously with your many stakeholders	S1
stay focused on common goals	S1
bs/ba degree	K01
core java	K02
spring boot	S1
Microservices	S4
AWS	K02
Kubernetes	K02
Docker	A1
Spinnaker	A1
devops	K04
ci/cd automation	S4
application data and infrastructure architecture disciplines	S4
industry-wide technology trends and best practices	S1
work in large collaborative teams	S1
achieve organizational goals	S1
building an innovative culture	S4
business analysis	K04
development	K02
maintenance	K04
software improvement	S4
artificial intelligence	K04
machine learning	K09
translation	S1
node.js	K04
javascript	K02
nestjs	A1
artificial intelligence	K04
machine learning	K09
translation	S1
node.js	K04
javascript	K02
nestjs	A1
design and develop a micro-service architecture	S4
gather understand and prioritize requirements	S4
research potential solutions	S4
rapidly build prototypes	K04
distill and communicate what was learned expected risks necessary resources	S1
security concerns	S4
provide high-level technical design	S4
strategy roadmap development	K04
technical architecture	S4
assure that our architectures are consistent	S4
industry best practices	S1
scalability	K04
availability	S4
maintainability	K04
flexibility	A1
communicate strategies and processes	S4
select the best talent to join	S4
onboard new colleagues	S4
javascript	K02
typescript	K02
node.js	K04
NestJS	A1
writing highly tested software	S1
unit testing	K04
integration	S1
defining and modelling a consumable api	S4
work autonomously	A1
energized by missions and goals	S1
designing	K04
analyzing	A1
optimising code	A1
troubleshooting large-scale distributed systems	S4
python	K05
django	A1
docker	A1
orm	K02
sqlalchemy	S1
python	K05
django	A1
docker	A1
orm	K02
sqlalchemy	S1
lead the design & implementation	S4
back-end services	S4
drive the implementation of new forecasting algorithms and tooling	S4
responsibility for live productions systems	A1
perform developer tests	S4
peer code reviews	S1
prepare strong documentation	S4
develop tools	S1
improve and maintain components & systems	S4
python	K05
back-end programming	S4
database structures	K04
webapp design	K04
python	K05
orms	S1
Django	A1
ORM	K02
SQLAlchemy	S1
designing & implementing distributed system architectures and apis	S4
docker	A1
deploy your applications	S4
computer engineering	S4
manage individual priorities deadlines and deliverables	A1
contribute to engineering efforts	S4
solve complex engineering problems	S4
get-things-done attitude	S1
identify shortcomings quickly	S1
statistical modeling	K04
optimization problems	K09
work with many different stakeholders	S4
english	K02
eu/efta or swiss work permit	S4
information technology	S1
online travel	S4
java	K02
web-services	S1
python	K05
distributed-system	S1
amazon-web-services	S4
information technology	S1
online travel	S4
java	K02
web-services	S1
python	K05
distributed-system	S1
amazon-web-services	S4
java	K02
python	K05
Docker	A1
AWS	K02
hadoop/spark	K01
sql	K02
airflow	A1
Jupyter	A1
agile/lean	S4
base your decisions on solid data and metrics	S1
produce outstanding work	S4
break challenges into bite-size tasks	S4
mentor team mates	S1
demand quality	K04
machine learning	K09
cloud services	K02
apis	K09
developing a whole range of key product features	S4
defining and implementing services	S4
collaborate with product engineers	S4
accountable for your own projects	S1
trusted to deliver	A1
form part of a broader team	S4
takes collective responsibility	A1
making success happen	S4
mobile application	S4
android	K02
mobile	A1
kotlin	S1
architect	K02
build	S4
maintain	K10
tackle challenges	S4
find creative ways to implement new features	S1
Kotlin	S1
RxJava	S1
Couroutines	K04
share your knowledge	S1
keep up the high level of quality	A1
reviews	S7
pairing	K09
mentoring	K01
focus on a top-notch user experience	A1
make the app context aware	S1
google awareness api	K04
improve of our sync framework	S1
build features	S4
location based services	S1
design	K02
ui	K02
ux	K04
mobile technologies	S4
mobile wallets	S4
android sdk	A1
coding	K04
Kotlin	S1
solving technical challenges	S4
ios app	K01
backend development	K04
degree	K01
computer science	K05
android	K02
payment	K10
loyalty	A1
shopping	K02
eCommerce	S4
internet marketing	K04
java	K02
spring	K02
node.js	K04
reactjs	A1
high-quality well-tested and scalable code	A1
ensure code quality and maintainability	A1
evolving architecture and tech stack	S4
code reviews	S7
refactoring	K04
standards	K02
improving build and test systems	S4
coach guide and mentor teams	S4
architecture	K04
technology	K02
collaborate	K09
identifying managing and minimizing technical debt	S4
share architecture knowledge findings and standard methodologies	S1
java	K02
spring framework	S1
web technologies	S4
( non- ) relational databases	S1
node.js	K04
react	A1
design implementation and operation of distributed services and apis	S4
strategic thinker	S4
analytical	K04
critical thinking	S1
frame problems	S1
drive teams	S4
collect data	K09
guide the analysis	S1
present the data	S4
influence leadership	S4
agile software development	S1
product discovery	K04
continuous deployment	S4
aspiration for quality	S1
sense of pragmatism	A1
quality assurance	S4
quick adoption of new technologies	S1
speak at conferences	S1
engage in the community	S1
english	K02
communication	S1
