questioning	A1
expressing self clearly and	S3
seek develop and secure new opportunities	A1
measure monitor and review performance of key accounts	S4
ensuring budgets and forecasts are met	S4
identify and monitor key performance and financial indicators	S4
maintain and monitor service expectations of existing and key accounts	S4
support external sales force	S1
management of business	S4
select appropriate carrier	A1
maximise freight profits	S4
manage your own time	A1
integrate and co-ordinate new business	S4
arrange regular meetings	S4
submit financial reports	S4
CIMA	S4
care deeply	A1
ever-changing environment	S4
excel	A1
shape the world of iot	S4
advocate quality	A1
verify	A1
validate	A1
analyze	A1
lower risks	S4
automate tests	K09
build great products	S4
shape the features	A1
cloud-based microservices	S3
audio/video pipelines	S1
machine learning	S1
mobile applications	S4
critical thinker	A1
user experience	A1
quality	A1
software testing	K01
curiosity	K09
resourcefulness	A1
find problems	S1
provide creative solutions	S4
software testing techniques	S4
advocate for quality in decision making	A1
tinkerer	A1
create your own apps and robots	S4
working closely with developers	S4
diligent with documenting your test plans test cases bug reports	S3
coding	S4
python	A1
java	A1
javascript	K02
Golang	S1
selenium	A1
TestCafe	S2
web	S1
api	S1
backend	S3
integration	S1
performance/load/stress	A1
security testing	S2
continuous integration	S4
continuous delivery and/or deployment	A1
jenkins	A1
CircleCI	S4
linux	S4
Docker	A1
Kubernetes	K09
web services	S1
networking	S1
distributed systems	S4
cloud services	S4
GraphQL	A1
driving?	S4
fast-paced team environment?	S4
upholding a positive brand image	A1
providing excellent customer service	A1
managing cash and card transactions	S3
delivering products safely and securely	A1
avoiding unnecessary risks	S3
safety and security procedures	A1
uk or eu driving license	S4
own car	A1
local area	S4
fast-paced environment	K09
customer service	S1
quality	A1
driving!	A1
food hygiene	A1
store cleanliness	S4
keen eye for detail	A1
day to day running of kitchen ordering and installs	S4
work closely with our installation team	A1
deliver projects efficiently	A1
maintain an impeccable level of customer service	S4
joinery	A1
kitchen industry!	A1
email	A1
organisational skills	S1
self-motivated	A1
working on their own initiative	A1
communicator	S1
kitchen industry	A1
computers	S1
attention to detail	A1
building and maintaining strong relationships	S4
multi-task	A1
deliver against deadlines	A1
valid uk driving license	A1
communication skills	S1
kitchen industry	A1
valid uk driving licence	A1
a-level	S1
support the bakery management team	S4
support the teams	S1
go above and beyond for our customers	A1
positive	A1
energetic	A1
engaging with people	S1
communications skills	S1
talented	A1
fun	A1
ambitious	A1
provide first line support to our team of colleagues	S1
reporting directly to the head of team experience	S3
overseeing hr administration	S4
maintaining hr records	S4
compiling hr data	S4
running reports	S4
managing hr processes	S4
hr best practices	S1
processes	A1
policies	A1
employment law	S1
organisation	S4
attention to detail	A1
positive	A1
professional	A1
communication	S1
literacy	S1
numeracy	K05
it skills	S1
willingness to develop	A1
line management	S1
level 5 cipd	S1
Kronos	A1
maximising sales	S1
building a highly engaged and high performing team	A1
leading from the front	S4
hands-on approach	A1
inspire your team	A1
inject fun into the work place	S1
create a truly amazing place to work	A1
delivers an exceptional standard of customer service	A1
pet knowledge	A1
deliver the highest standards of pet care	S3
ensure that the welfare of pets is a top priority	K09
promoting responsible pet ownership	S4
motivating training and developing your team	S4
running a store	S4
achieving and exceeding key store targets	A1
communicate effectively to your team	S1
take full responsibility for the store	A1
involved in absolutely everything in your store	A1
recruitment	K09
stock control	S4
store standards	A1
retail	S4
pets!	S1
supervisory/management	S4
hands-on approach	A1
delivering high standards!	S4
people person	A1
team player	A1
communication	S1
engage and inspire a team	A1
proactive	A1
customer focused	A1
recording of events and service failures	S4
chasing and completion of calls	S4
production of work request failures	S1
liaising with internal team and external contractors	S4
maintenance of records of live and paid works	S4
kpi's	S4
SLA's	A1
raising purchase orders	A1
completion of worksheet upload spreadsheet	S1
cafm system administration	S4
assisting the helpdesk manager	S4
general office administration duties	A1
reporting	S1
provide minutes of meetings	S4
contract administration	S4
ensure the helpdesk operates professionally	S3
manage the lines of communication	S1
achieve a high degree of customer and supplier satisfaction	A1
achieving key performance indicators ( kpis	S4
customer service	S1
system knowledge	A1
operate a helpdesk function across multiple sites	S1
accurately record details of the caller problem and severity	S3
ensure that the service centre manager is aware of situations which could develop into issues	S4
work within and to processes and procedures	S1
respond quickly and efficiently to all requests	S3
attention to detail	A1
obtaining and inputting information	S1
clear and professional telephone manner	A1
achieve a high degree of customer and supplier satisfaction	A1
applying logic and common sense	K09
ensuring that identified criteria are escalated	S4
scheduling ppm remedial and reactive work	S1
jeopardy management	S4
escalation of planned and responsive works	S4
monitor and optimise the utilisation of engineer activities	S3
scheduling of works	A1
raising purchase orders	A1
run reports	S4
show outstanding work orders	S1
attend training and coaching sessions	S4
identify any potential areas of improvement	S4
flexible	A1
adaptable	A1
highlight any training needs and development	S1
operating a facilities management helpdesk	S4
call centre service	S1
developing productive working relationships	S1
qfm helpdesk system	S4
computer hardware	S1
peripherals	K09
applications	S4
networks	S1
shared files and folders	S1
report creation	S4
keyboard skills	A1
focusing on client & customer	S3
delivering stretched results	S1
act collaboratively	A1
intellectual agility	A1
willingness to learn	A1
computer databases	S1
nvq level 2 or 3	K09
customer service	S1
call handling	S1
working with and developing kpiâ€™s and measurement information	S4
rsa level i keyboard skills	S4
european computer driving licence ( ecdl ) level i	S3
microsoft word	A1
microsoft excel	A1
level 2 & 3 nursery	S3
providing care and educational support	S1
pms	S1
reservation systems	S4
customer service?	S1
organised analytical approach	S2
numerical skills	S1
pms	S1
reservation systems	S4
timekeeping	A1
work calmly in a high-pressure environment	A1
english	L1
making reservations	S4
ensuring that all enquiries receive a prompt response	A1
all correspondence is accurately filed	S3
log failures	S4
convert a booking	S4
monitor non-arrivals and late cancellations	S1
run daily arrival checks	S4
ensure all reservations are correct	S3
work with others	S1
improve our customer service	S1
cover reception	S4
monitoring and recording key data	S4
keeping the pms up-to-date	A1
ensure that market segmentation rates and guest information are accurately recorded	S4
helping the hotel to achieve its financial targets	S3
upsell	A1
escalate/communicate about any new sales leads	S4
contribute to pricing decisions	S4
highlighting if availability is changing	A1
rate strategies should be reviewed	S4
pms	S1
reservation systems	S4
organised	A1
analytical	A1
customer service	S1
commercial awareness	S4
corporate tax	S4
personal tax	S1
vat	A1
ACCA/ACA/ATT	S4
cta	S4
supporting and training the more junior member of staff	S4
manging	K09
supervising	K09
coaching	S4
mentoring	S1
work with a varied portfolio	A1
provide compliance and advisory services	S4
support clients	S4
services in corporation tax and personal tax	S1
work in a varied capacity	A1
confident	A1
professional	A1
ambitious	A1
tax planning	S4
advisory work	A1
tax computations and reviews	S1
capital gains tax	S4
trusts	S1
inheritance tax/wills	S1
property tax	A1
corporate tax planning	S4
mergers & acquisitions	S4
restructuring	A1
investments	S1
dealing with a variety of high net worth individuals partnerships directors tax omb	S4
manage the team	S1
planning and reviewing work in progress	S4
supporting the directors	S4
providing direction to the team	A1
lead and grow the department	S1
business development	S1
selling services	S1
CIMA	S4
help residents enjoy each day	S1
assist with daily living	S1
providing support and companionship	A1
dedication	A1
compassion	S4
supporting residents with their food and drink	S3
following care plans	S1
caring for older people	S4
can-do approach	A1
communication skills	S1
empathy	A1
warm-hearted approach	S1
compassion	S4
deliver the highest standard of care and support	S1
drive expansion	S4
exceed monthly / quarterly sales targets	A1
driving new opportunities	S4
exceed monthly / quarterly sales targets	A1
driving new opportunities	S4
analyse your industry territory	S1
identify prioritise and segment accounts	S4
collaborating	K09
create demand	S4
cold calling	S4
email / social campaigns	S4
supporting other business development activities	S4
engage your extended team	A1
engage with prospect organisations	A1
strategic value-based selling	S1
business case definition	S4
return on investment analysis	S1
references	S1
analyst data	S1
engage with customer cios and cfos	S4
converse with senior technologists	S4
generate short term results	S1
maintaining a long term perspective	A1
maximize overall revenue generation	A1
provide accurate monthly forecasting and revenue delivery	A1
build and maintain a territory pipeline of business	S4
selling enterprise software	S4
PaaS	S4
IaaS	S1
saas	S4
net direct new business sales	S1
consistent delivery against targets	A1
strong customer care	A1
helping to ensure customer success	S4
credibility	A1
building strong relationships internally and with the customer	S1
selling industry-specific use cases / technologies	S4
CPG	S4
manufacturing	S4
services	S1
iPaaS	S1
api management	S4
automation	A1
bpm	S4
deliver key business outcomes	S1
bachelorâ€™s degree	K01
full driving license	S4
internal framing work	S1
finishing work	A1
skirtings	K10
facings	S1
cscs card	K06
carpentry	A1
CSCS	S4
electro/mechanical assembly	A1
hand assembly	A1
wiring electronic sub-assemblies	S3
mechanical assembly	A1
working to customer specifications	S4
can do attitude	A1
driving	S4
strategic planning & governance	S4
strategic planning	S4
performance reporting	A1
strategic planning	S4
corporate performance	A1
manage the strategic planning and corporate performance reporting functions	S1
manage the strategic and operational planning process	S4
support senior colleagues	S4
completing plans	S4
provide specialist advice	S4
guidance	S1
support to managers staff and the public	S1
strategic planning	S4
corporate performance	A1
conduct stakeholder consultation/engagement	S4
engage with internal and external groups and networks	S4
development or expansion of good practice	S4
strategic planning	S4
corporate performance	A1
coordinate the preparation of an annual report	S4
ensure the annual report complies with the government financial reporting manual ( frem	S3
government financial reporting manual ( frem	S1
analytical decision making	A1
communication skills	S1
maintain positive relationships	S1
seek information and co-operation	S1
conduct trend analysis on complex data sets	S4
working with stakeholders	S4
inform of any discrepancies variances and trends	S3
scqf level 9	A1
technology	A1
project manage	A1
bridge the gap	A1
liaising with many stake holders	S4
influencing and negotiation skills	S1
prince2 practitioner qualification	S4
msp qualification	A1
project management	S4
change management	S4
benefit realisation	A1
workforce redesign	S4
energetic	A1
work independently as well as in a team	A1
persistent	A1
sales	S1
B2B	S4
concept sales	S4
business	A1
english	L1
french	S4
german	A1
java	A1
working in the web layer	S1
working as a key member of an agile team	A1
frequent delivery	A1
end-to-end application ownership	A1
contributing to a cross functional agile team	S4
elaboration development and testing of user storiesÂ•	S4
sprint planning	A1
backlog grooming	A1
task estimationÂ•	S4
development and modification of frameworks common components and business componentsÂ•	S4
development of unit tests	S4
contribution to the creation of automation in higher levels of the test pyramidÂ•	S4
refactoring code	S4
contribution to code quality improvementsÂ•	S4
development standards	S4
best practices	S1
software development	K01
review of colleagueÂ’s codeÂ•	S2
progressive development behaviours	S4
maximizing collaboration	K09
knowledge sharing	A1
effective pairing	A1
creation of pocÂ’s / spike development	S4
involvement in technology evaluation	A1
work and communicate across geographical and cultural borders	S1
build a strong professional network	S4
participation in the elaboration of user stories	S3
agree stories are sufficiently described	A1
quality design and implementation	A1
ensuring builds are kept green	A1
code management strategy ( branching ) is closely	A1
raising capability and standards	S4
pairing on tasks	S1
peer review of team membersÂ’ code	S4
constructive feedback for improvement	S4
proactive contribution to continual improvements	S1
active participation in retrospectives	K09
engagement with cross team bestpractice	S1
support product owner	A1
identify and manage risks debt issues and opportunities	S4
support the recruitment activities	S3
technical support	A1
technical support	A1
implementation skills	S1
java	A1
SpringBoot	A1
unit testing	K09
development	A1
agile	A1
integration of testing into development workflow	S1
test frameworksÂ• build tooling	S3
maven)Â•	S1
work in ui	S1
continual delivery pipeline tools	S1
jenkins	A1
ansible	K09
communication skills	S1
articulate clearly to technical team members	S4
work with product owners	S4
collaborative	K09
critical reasoning	A1
problem solving	A1
agile software development	A1
xp	K01
BDD	S1
TDD	A1
fast turnaround development	A1
continuous delivery	A1
service orientated	A1
microservice architectureÂ•	K02
shared-nothing architecture	S1
domain driven design	A1
bounded contextÂ•	K09
high volume transactional systemsÂ•	A1
api gateway	S4
Akana	A1
coherent software architecture and designÂ•	A1
message or event based architecturesÂ•	S4
eventual consistency concepts	A1
contributor to open source projects	S4
mechanical understanding	S1
automation	A1
process optimization	S4
support and problem-solving	A1
decanters	A1
high-speed separators	S3
putting put the customer first	S4
preventive maintenance of supplied equipment and machines	S3
repair and service according to customer requirements	S1
support to customers	S1
general technical support	S3
adjustments to equipment and machines	K09
start-up and commissioning of machinery	S4
process plants on board vessels	S1
training of the crew	S4
optimization of plant and equipment	K09
decanters	A1
high-speed separators	S3
PureBilge	A1
FWG	S4
pure	L1
marine business	A1
sailing	A1
mechanical understanding	S1
automation	A1
control systems	S4
microsoft office	A1
danish	L1
english	L1
developing our new data backbone	S3
inspiring the stakeholders	S4
advanced analytics	S4
artificial intelligence	A1
extracting insights and value from data	S1
applying domain expertise	A1
ensure data collection procedures	S1
building analytic systems	S4
operationalise data mining and analysis into business applications	S4
maintain the productionised models	S3
quantitative or data-heavy functions	S1
c#	A1
python	A1
java	A1
open source data ingestion tools	S1
nifi	K09
cloud platforms	S4
container technology tools	A1
analytics engines	S4
spark	S3
Databricks	S1
data visualisation tools	S1
cloud platforms	S4
machine learning	S1
algorithms	S4
willingness to learn	A1
criminal record certificate	K09
criminal record certificate	K09
criminal record certificate	K09
registering and controlling goods	S4
picking and packing	S3
preparing pallets	A1
loading and unloading lorries	S4
operating a forklift	S4
forklift license	S4
independently	A1
proactively	A1
set high standards	S4
flexible	A1
helpful	A1
developing and applying new optical microscopy techniques	S3
intestine	S1
biopharmaceuticals	K09
reinvent our research strategies	S4
constructing a 'light sheet' fluorescence microscope	A1
live-sample imaging	S1
3d printed organoids	S3
pursue a deeper understanding	A1
implementing one of the worlds most advanced optical microscopes	S3
use the microscope	S1
capture how fluorescently labelled biopharmaceuticals travel through the intestinal barrier	S3
optimizing microscope hardware and software	S4
provide the best images	S1
drive hardware/software development	S4
document present and publish scientific findings	S3
contribute to the enjoyable and collaborative work environment	A1
master's degree	K01
work independently	A1
prioritize tasks	S1
plan and execute complex hardware implementation	S4
interface optics	S1
electronics	S4
software	K02
work constructively in a team	A1
analyse	K09
contribute	S4
solve biological/mathematical challenges	S4
use software for instrument control	S3
labview	A1
use software for data simulation	S1
basic image analysis	A1
matlab	A1
use software for basic mechanical design	S3
SOLIDWORKS	A1
communicate professionally	A1
english	L1
present insights progress and bottlenecks	S4
european code of conduct for research integrity	S1
software/hardware development	S1
fundamental biology/physiology	K09
bsc/msc diploma	S4
research	S1
teaching	S4
marketingÂ—in	A1
business	A1
development	A1
active engagement	A1
strengthen the relationship	S1
initiate and participate in external funding	S4
sustained record of research publications	S4
research management	S4
teaching	S4
provide dynamic leadership	A1
teaching	S4
research dissemination	S4
working with business and society	S1
undertaking research	A1
teaching practice	S4
dissemination	K09
business research	S1
research management	S4
initiation of research projects	S4
supervision of ph.d	S3
international research co-operation	S4
journal editorship	K09
reviewing for academic journals	A1
academic development	A1
marketing	S1
research-based teaching	S1
supervision	K09
examination	K09
teaching on business research	S4
course and program development	S4
promotion	K04
participation in and possibly initiation of externally funded research projects	S4
contribution to the administrative responsibilities	A1
dissemination of research findings	S4
participation in the departmentÂ’s regular research activities	S1
engagement in and contribution to academic citizenship activities	A1
participate actively in the research and teaching activities	A1
maintain and establish broad links	S4
record of research	S4
teaching	S4
research management	S4
research	S1
teaching	S4
business research	S1
provide dynamic leadership	A1
development of research	S4
teaching	S4
research dissemination	S4
working with business and society	S1
achieving ) research grants	A1
pedagogical qualifications	K09
development and innovation in the pedagogical area	S4
english	L1
teaching qualifications	S4
teaching evaluations	S4
love being outdoors	S1
create an entertaining & memorable tour	A1
share your knowledge?	S1
responsible and professional work ethic?	A1
providing fun informative and engaging tours	A1
know all information provided	S1
run tours on time	S1
provide extensive information about the city	S3
answering customer questions	S1
show independent thinking	A1
professonal approach	A1
leadership	A1
assiting with teambuilding excercises	A1
leading	S1
meticulous	A1
detail-oriented	S4
ensure the shop is tidy and clean	A1
dusting	S1
vacuuming	K09
set up for your customers	S1
independent work approach	A1
street-marketing	S4
street-marketing	S4
approaching people	S4
confident	A1
engaging	A1
english	L1
german	A1
danish	L1
lively	A1
fun	A1
public speaking	S1
engage an audience	S1
responsible	A1
dutiful	A1
mature	A1
demonstrate leadership abilities	A1
service-minded	A1
providing a first-class experience	A1
perform at your best ability	S1
high-school diploma	K01
bachelor/post-graduate degree	K01
danish	L1
english	L1
service-industry	A1
tourism	A1
social media marketing	S1
sales	S1
Segways	A1
first-aid skills	S1
stamina	K09
love for being outdoors	A1
supply chain	A1
manage challenges	A1
business acumen	S1
planning skills	S1
collaborating	K09
ensure reliable supply	A1
operating in a structured formal monthly sales and operations planning process	S4
sales and operations planning process	S4
maximize product availability	A1
standardized global processes	S4
sap	K06
optimize supply and inventory plans	S4
lead supply scenario analysis	S4
monitor supply and capacity performance	K09
coordinate supply and capacity bottleneck management	S4
support the supply risk management process	S4
respond to ad hoc requests	S3
establish and develop a close collaboration	A1
planning	S4
masterÂ’s degree	K01
business	A1
engineering	S4
supply chain management	S4
supply chain	A1
sap apo	S1
providing ideas and input for optimization	S4
handle hands-on planning tasks	S1
complex coordination	S4
overview	A1
sense of detail	S4
open-minded	A1
establish collaborative relations to people	S1
tailor your communication to your audience	S1
make people prioritize your agenda	S4
advanced electron microscopy	K09
environmental catalysis	K09
nanomaterials	A1
selective catalytic reduction ( scr ) of nox	S4
undertake atomic-scale studies	S1
situ transmission electron microscopy	K09
characterization tools	A1
surface science techniques	S3
catalyst testing	S4
synthesis	A1
develop an understanding of the catalytic performances	S4
target new designs of catalyst materials	S3
improving nox emission control	S4
experimental research	S1
scr catalysts	S4
application of s/tem and eels for atomic-resolution and in situ studies	S3
develop our atomic-scale model	S4
scr	S4
scr catalysis	K09
publishing in high-profile journals	S1
committed	A1
flexible	A1
innovative mind-set	A1
new ideas	A1
ready to face new challenges	A1
take responsibility	A1
execute and communicate complex research goals	S4
enthusiastic	A1
catalysis sciences	A1
Ph.D	K01
physics	K09
chemistry	S3
high-resolution ( scanning ) transmission electron microscopy ( s/tem	S1
heterogeneous catalysts	S1
solid-state nanomaterials	S4
audio engineering	S4
acoustic design	K02
algorithm trimming	A1
sound quality evaluation	S4
passion	A1
creativity	A1
work on new algorithm concepts	S1
directionality/beam-forming	S3
trimming and verification of various audio algorithms	S2
audio engineering	S4
msc	K09
outgoing	S4
getting things to move forward	S3
inspires your colleagues	S1
dealing with many stakeholders	S4
setting a direction	S1
english	L1
audio engineering	S4
algorithm concepting	S4
directionality	A1
beam-forming	S3
matlab	A1
python	A1
trimming of various audio algorithms	S3
noise reduction systems	S3
eq	A1
compressors	A1
objective and subjective sound quality evaluation	K09
measurement systems for audio evaluation	S3
soundcheck	A1
head acoustics acqua audio analyzers	S4
communicating technical issues	S1
research the market	S1
take initial contact to potential clients	S1
carry out market research of potential clients	S4
establish initial contact to potential clients	A1
translate sales material	S1
english	L1
italian	A1
italian	A1
english	L1
tele marketing	S1
proactive on the phone	S1
independent	A1
positive	A1
proactive	A1
danish	L1
working in a sales department	S4
leading technology strategy roadmaps and transformation plans	S4
communication	S1
integration	S1
PLM/PDM	S4
manufacturing execution	S4
product quality systems ( qsys	A1
global erp ( sap ) platforms	S4
dynamic	A1
personal motivation	S1
drive	A1
approach complex tasks	S4
open mind	A1
focus	A1
providing the best solution	A1
structured	A1
analytic	A1
lead the technology roadmap	S4
participate actively in strategic projects	A1
PLM	K01
main interface between plm data and systems governance organizations	S1
lead and coach a team	S1
PLM	K01
model and control enterprise plm architecture ( data and systems	S1
TOGAF	A1
asses value propositions of project proposals	S2
Teamcenter	S1
PLM	K01
how systems interact with erp	S1
manufacturing execution systems	S4
PLM	K01
erp systems	S4
capturing requirements from large organizations	S3
architecting value creating solutions for the business	S4
enabling the software to create value	S1
processes	A1
lifecycles	A1
wind turbine	A1
communicate on all levels	S1
persuasive communicator	A1
english	L1
teaching	S4
research	S1
basic and applied nutrition of ruminants	S3
dairy cattle	A1
dairy production	A1
data modelling	S1
evaluation of feed quality and feed intake in dairy cattle	S1
nordic feed evaluation system	S4
NorFor	A1
dairymanagement system	S4
feed evaluation	S1
digestive processes	S4
intermediary metabolism	K09
impact of nutrition and feeding management	S3
animal health	K09
product quality	A1
research	S1
publication/academic dissemination	S1
research-based teaching	S1
examination	K09
sharing knowledge with society	S4
phd degree	K01
research	S1
teaching	S4
enterprising	S4
interpersonal skills	S1
information technology	S1
java	A1
algorithm	A1
database	L1
multithreading	K09
concurrency	A1
solve technical challenges	S4
deliver high quality code	A1
build and ship new features	S3
write high quality testable and efficient code	A1
promote new ideas	S4
take active part in features discussions and roadmap prioritisation	S4
integrate cutting edge research and technologies	S1
work closely with our customers and other teams	S1
developing production level software	S4
designing multi-threaded systems and algorithms	S4
system design	K02
data structures	A1
algorithms	S4
java	A1
troubleshooting	A1
performance profiling	A1
optimisation	A1
development methodologies	S1
care about code quality	A1
communication skills	S1
sense of humor!	A1
eCommerce	S4
price comparison	S4
online portal	S1
.net	S1
agile	A1
rest	A1
microservices	S4
eCommerce	S4
price comparison	S4
online portal	S1
.net	S1
agile	A1
rest	A1
microservices	S4
development test and deployment of new components	S4
transition	S4
re-engineering	S4
design	K02
extension	A1
continuous integration	S4
continuous deployment	S4
.net	S1
micro services	S4
development and implementation of rest api's	S4
web and/or e-commerce	S1
agile method practice	A1
english	L1
german	A1
data science	A1
it security	A1
software development / engineering	S4
java	A1
rest	A1
cloud	S3
spring	A1
design-patterns	S1
data science	A1
it security	A1
software development / engineering	S4
java	A1
rest	A1
cloud	S3
spring	A1
design-patterns	S1
enthusiasm	A1
professional attitude	A1
work together closely with product owners and colleagues	A1
develop an in-depth understanding of the domains and the requirements	S3
happy to share your valuable insights	S1
offer them professional advice	A1
share your knowledge	S1
advise individual colleagues	S4
software development	K01
agile project team	A1
java stack frameworks	S4
quality	A1
testing at various levels in an agile environment	S4
test automation	S1
clear easy-to-maintain code	A1
latest technologies	S4
back end development	S1
databases	S1
cloud computing	S4
restful api	S2
big data	A1
devops	K01
build implement and operate a system	S4
architecture concepts	K02
design patterns	S1
german	A1
english	L1
digital agency	S1
software development / engineering	S4
user experience	A1
javascript	K02
angular	K01
reactjs	S1
vue.js	S4
typescript	K01
digital agency	S1
software development / engineering	S4
user experience	A1
javascript	K02
angular	K01
reactjs	S1
vue.js	S4
typescript	K01
develop attractive state-of-the-art user interfaces	S3
application architecture	K09
api design	K02
implementation of functionality	S1
code reviews	A1
technical advice for our customers	S3
guidance and support for your teammates	S1
realize exciting projects	S3
degree in computer science	A1
javascript/typescript	S3
angular	K01
react	S1
vue	S4
architecture of complex single page applications	S4
accessibility	A1
usability	A1
current web standards	S4
code quality	A1
clean code	A1
quality and responsibility	A1
eye for aesthetics design	S3
faithful implementation	K09
german	A1
english	L1
financial services	A1
financial technology	A1
regulatory reporting	S4
c#	A1
typescript	K01
.net-core	S1
less	K01
sql-server	S4
financial services	A1
financial technology	A1
regulatory reporting	S4
c#	A1
typescript	K01
.net-core	S1
less	K01
sql-server	S4
deliver software solutions	A1
creation of programs	S4
configuration/customisation of platforms	S4
capture & analysis of requirements	S4
requirements capture/analysis and documentation	S2
design ( and documenting ) of own solutions	S3
writing software	S1
configuring software platforms	S4
troubleshooting	A1
debugging code	A1
testing	K09
analysis of test results	S1
documentation	K09
microsoft	A1
web development	S1
c#	A1
.net core	S4
.net framework	S1
sql	A1
sql server	A1
typescript	K01
javascript	K02
asp.net	S1
Blazor	A1
javascript	K02
JQuery	A1
angular	K01
react	S1
vue	S4
html5	K02
css ( less	S1
Bootstrap	S4
troubleshooting it infrastructure related issues	S4
microsoft-based development environment	A1
microsoft certifications	S4
team player	A1
methodical and reliable approach	A1
problem solving	A1
financial services	A1
communication skills	S1
java	A1
testing	K09
web-services	S1
java	A1
testing	K09
web-services	S1
solving business problems	A1
innovation & engineering practices	A1
apply your depth of knowledge and expertise	S1
software development lifecycle	S4
partner continuously with your many stakeholders	S1
stay focused on common goals	A1
creating api services	S4
work closely with colleagues and the business	A1
functional and non-functional requirements	A1
drive the design and implementation of well tested easily supportable scalable and robust solutions	S4
bs/ba degree	K01
deployment approaches	S2
considerations	K09
managing deployments	A1
industry wide technology strategies	S4
best practices	S1
work in large collaborative teams	S4
achieve organizational goals	S4
building an innovative culture	A1
java ( version 8 or higher	S3
spring boot	S1
performance testing	S4
unit testing	K09
integration testing	S1
behavioural testing frameworks	S2
mocking frameworks	S4
continuous integration	S4
designing applications	S4
high throughput mission critical high performance stp platforms	S4
designing and building reusable services	S4
support the developers in your team	S3
leading	S1
supporting	S1
coaching	S4
application delivery	A1
stakeholder management	S4
oracle	A1
cloud services	S4
information technology	S1
technology consulting	S4
.net	S1
microsoft-dynamics	S4
dynamics-365	S4
cloud services	S4
information technology	S1
technology consulting	S4
.net	S1
microsoft-dynamics	S4
dynamics-365	S4
developing	S7
development	A1
customisation	K09
configuration	S4
development of plug-ins	S4
c#	A1
work with business product owners and business analysts	S4
elicit requirements	A1
assist in developing design specifications	S4
maximise the benefit	S1
collaborate with other stakeholders/ end users	S4
software development lifecycle	S4
design	K02
development	A1
delivery	A1
dynamics 365	S4
dynamics crm	S4
dynamics 365	S4
.net	S1
ms dynamics 365	S4
technical aptitude	K09
providing extraordinary customer service influence impact	S1
problem-solving	A1
building customer and partner relationships	S4
microsoft stack	A1
dynamics 365	S4
scrum/agile	A1
sc clearance eligible	K09
.net webapi	S4
sharepoint	S1
vehicle tracking	S4
azure	A1
.net	S1
c#	A1
azure-cosmosdb	S4
rest	A1
vehicle tracking	S4
azure	A1
.net	S1
c#	A1
azure-cosmosdb	S4
rest	A1
development cycle	A1
analyzing	A1
deciding the best approach	S1
write code	A1
design patterns	S1
unit tests	K09
design	K02
write code	A1
.net	S1
modify .net services and apis	S1
apis	S1
maintain strong backend code quality	A1
c#	A1
.net framework	S1
.net core	S4
t-sql ( ms sql server	S4
object-oriented design	K09
restful services	K09
azure storage	A1
azure eventhub	S4
azure functions	S4
azure data lake	S4
azure cosmosdb	S4
security principles	A1
computer science	A1
engineering	S4
teamwork	A1
attention to detail	A1
resourceful	A1
problem solving	A1
communication skills	S1
english	L1
qa	S3
automation	A1
testing	K09
qa	S3
automation	A1
testing	K09
delivering real quality	S1
planning test activities for each build cycle	S4
testing client configurations	S4
reporting the results	S1
incorporating that testing into automation	S4
reporting and documenting issues found	S4
following up on issues raised	S3
communicator	S1
connect together complex issues	S1
appreciate quality	A1
testing	K09
automation	A1
complex system	A1
code	A1
financial services	A1
qa	S3
python	A1
automation	A1
financial services	A1
qa	S3
python	A1
automation	A1
automation	A1
functional testing	S2
regression/reconciliation	K09
new feature testing	S4
continuous delivery	A1
end to end automated testing	S3
data integrity	S1
performance	A1
presentation quality	A1
software development	K01
automate end to end test requirements	S4
java/python	A1
schedule and execute regression cycles	S2
execution of non-functional regression testing	K09
ensure the resiliency and performance of the system	S3
operational processes	S4
provide solutions	S1
improve operational efficiency	A1
agile	A1
participating in sprint planning backlog refinement	A1
retrospectives	S4
defect management	S4
of test coverage	S1
identify gaps	S4
provide improvements	A1
it/quality assurance	A1
bachelor's degree	K01
computer science	A1
quality assurance	A1
testing arena	S2
quality assurance methods/processes	A1
lifecycle principles	A1
quality assurance processes	S4
automated testing	K09
java	A1
python	A1
testing of mainframe	S4
test automation frameworks	S4
communicate	S1
work under pressure	A1
resolve issues affecting the production services	S3
detail oriented	A1
work independently	A1
core java	A1
unix scripting	S4
sql	A1
continuous integration ( ci	S1
git	A1
jenkins	A1
mainframe/ibm iseries	S4
iseries menu/end of day	S4
read/publish on message	S3
financial services	A1
cloud	S3
java	A1
amazon-web-services	S4
financial services	A1
cloud	S3
java	A1
amazon-web-services	S4
solving business problems	A1
innovation and engineering practices	A1
apply your depth of knowledge and expertise	S1
software development lifecycle	S4
partner continuously with your many stakeholders	S1
stay focused on common goals	A1
bs/ba degree	K01
core java	A1
spring boot	S1
Microservices	S4
AWS	S4
Kubernetes	K09
Docker	A1
Spinnaker	A1
devops	K01
ci/cd automation	S4
application data and infrastructure architecture disciplines	S3
industry-wide technology trends and best practices	S1
work in large collaborative teams	S4
achieve organizational goals	S4
building an innovative culture	A1
business analysis	A1
development	A1
maintenance	A1
software improvement	A1
artificial intelligence	A1
machine learning	S1
translation	S1
node.js	S1
javascript	K02
nestjs	A1
artificial intelligence	A1
machine learning	S1
translation	S1
node.js	S1
javascript	K02
nestjs	A1
design and develop a micro-service architecture	S4
gather understand and prioritize requirements	S4
research potential solutions	S4
rapidly build prototypes	A1
distill and communicate what was learned expected risks necessary resources	S1
security concerns	S4
provide high-level technical design	S3
strategy roadmap development	S4
technical architecture	A1
assure that our architectures are consistent	A1
industry best practices	A1
scalability	A1
availability	A1
maintainability	A1
flexibility	A1
communicate strategies and processes	S1
select the best talent to join	A1
onboard new colleagues	S4
javascript	K02
typescript	K01
node.js	S1
NestJS	A1
writing highly tested software	S3
unit testing	K09
integration	S1
defining and modelling a consumable api	S4
work autonomously	A1
energized by missions and goals	S1
designing	K02
analyzing	A1
optimising code	A1
troubleshooting large-scale distributed systems	S4
python	A1
django	A1
docker	A1
orm	A1
sqlalchemy	S4
python	A1
django	A1
docker	A1
orm	A1
sqlalchemy	S4
lead the design & implementation	S1
back-end services	S4
drive the implementation of new forecasting algorithms and tooling	S4
responsibility for live productions systems	A1
perform developer tests	S4
peer code reviews	S1
prepare strong documentation	A1
develop tools	S1
improve and maintain components & systems	S4
python	A1
back-end programming	S4
database structures	K09
webapp design	K04
python	A1
orms	S1
Django	A1
ORM	A1
SQLAlchemy	S4
designing & implementing distributed system architectures and apis	S4
docker	A1
deploy your applications	S2
computer engineering	A1
manage individual priorities deadlines and deliverables	A1
contribute to engineering efforts	S4
solve complex engineering problems	S4
get-things-done attitude	A1
identify shortcomings quickly	S4
statistical modeling	S4
optimization problems	S3
work with many different stakeholders	A1
english	L1
eu/efta or swiss work permit	S4
information technology	S1
online travel	S4
java	A1
web-services	S1
python	A1
distributed-system	S4
amazon-web-services	S4
information technology	S1
online travel	S4
java	A1
web-services	S1
python	A1
distributed-system	S4
amazon-web-services	S4
java	A1
python	A1
Docker	A1
AWS	S4
hadoop/spark	S4
sql	A1
airflow	S4
Jupyter	A1
agile/lean	A1
base your decisions on solid data and metrics	S1
produce outstanding work	A1
break challenges into bite-size tasks	S4
mentor team mates	S1
demand quality	A1
machine learning	S1
cloud services	S4
apis	S1
developing a whole range of key product features	S4
defining and implementing services	S4
collaborate with product engineers	A1
accountable for your own projects	S4
trusted to deliver	A1
form part of a broader team	S1
takes collective responsibility	A1
making success happen	S1
mobile application	S4
android	K05
mobile	A1
kotlin	A1
architect	A1
build	A1
maintain	A1
tackle challenges	S4
find creative ways to implement new features	S4
Kotlin	A1
RxJava	S1
Couroutines	S4
share your knowledge	S1
keep up the high level of quality	A1
reviews	S1
pairing	A1
mentoring	S1
focus on a top-notch user experience	A1
make the app context aware	S4
google awareness api	S1
improve of our sync framework	S4
build features	A1
location based services	S1
design	K02
ui	S1
ux	A1
mobile technologies	S4
mobile wallets	S4
android sdk	S4
coding	S4
Kotlin	A1
solving technical challenges	S4
ios app	S4
backend development	S4
degree	K01
computer science	A1
android	K05
payment	A1
loyalty	A1
shopping	A1
eCommerce	S4
internet marketing	S1
java	A1
spring	A1
node.js	S1
reactjs	S1
high-quality well-tested and scalable code	A1
ensure code quality and maintainability	A1
evolving architecture and tech stack	A1
code reviews	A1
refactoring	A1
standards	S1
improving build and test systems	S4
coach guide and mentor teams	S4
architecture	K02
technology	A1
collaborate	K09
identifying managing and minimizing technical debt	S3
share architecture knowledge findings and standard methodologies	S1
java	A1
spring framework	S4
web technologies	S4
( non- ) relational databases	S1
node.js	S1
react	S1
design implementation and operation of distributed services and apis	S4
strategic thinker	A1
analytical	A1
critical thinking	A1
frame problems	S4
drive teams	S4
collect data	K09
guide the analysis	S4
present the data	S1
influence leadership	A1
agile software development	A1
product discovery	S4
continuous deployment	S4
aspiration for quality	A1
sense of pragmatism	A1
quality assurance	A1
quick adoption of new technologies	S4
speak at conferences	S4
engage in the community	S1
english	L1
communication	S1
