questioning	K04
expressing self clearly and	S4
seek develop and secure new opportunities	S4
measure monitor and review performance of key accounts	S4
ensuring budgets and forecasts are met	S4
identify and monitor key performance and financial indicators	S4
maintain and monitor service expectations of existing and key accounts	S4
support external sales force	K10
management of business	K04
select appropriate carrier	A1
maximise freight profits	S4
manage your own time	A1
integrate and co-ordinate new business	S4
arrange regular meetings	S4
submit financial reports	S4
CIMA	K02
care deeply	K04
ever-changing environment	S4
excel	K06
shape the world of iot	S4
advocate quality	K04
verify	A1
validate	A1
analyze	A1
lower risks	S4
automate tests	K09
build great products	S4
shape the features	S4
cloud-based microservices	S4
audio/video pipelines	K10
machine learning	K04
mobile applications	S4
critical thinker	A1
user experience	A1
quality	K02
software testing	K04
curiosity	K04
resourcefulness	K09
find problems	S4
provide creative solutions	S4
software testing techniques	S4
advocate for quality in decision making	S4
tinkerer	A1
create your own apps and robots	S4
working closely with developers	S4
diligent with documenting your test plans test cases bug reports	S4
coding	K04
python	A1
java	K02
javascript	K02
Golang	S1
selenium	A1
TestCafe	K09
web	K02
api	K02
backend	K02
integration	K09
performance/load/stress	S2
security testing	K04
continuous integration	K04
continuous delivery and/or deployment	S4
jenkins	A1
CircleCI	K10
linux	K02
Docker	K04
Kubernetes	S4
web services	K02
networking	K04
distributed systems	K09
cloud services	K04
GraphQL	K02
driving?	S4
fast-paced team environment?	K04
upholding a positive brand image	A1
providing excellent customer service	S3
managing cash and card transactions	S4
delivering products safely and securely	S4
avoiding unnecessary risks	S4
safety and security procedures	S4
uk or eu driving license	K09
own car	A1
local area	S4
fast-paced environment	K04
customer service	K10
quality	K02
driving!	S4
food hygiene	K10
store cleanliness	S4
keen eye for detail	A1
day to day running of kitchen ordering and installs	S4
work closely with our installation team	S4
deliver projects efficiently	S4
maintain an impeccable level of customer service	S3
joinery	A1
kitchen industry!	A1
email	K02
organisational skills	S1
self-motivated	A1
working on their own initiative	S4
communicator	K04
kitchen industry	A1
computers	S4
attention to detail	A1
building and maintaining strong relationships	S4
multi-task	A1
deliver against deadlines	S4
valid uk driving license	S4
communication skills	S1
kitchen industry	A1
valid uk driving licence	S4
a-level	A1
support the bakery management team	S4
support the teams	S4
go above and beyond for our customers	S3
positive	A1
energetic	A1
engaging with people	S4
communications skills	S1
talented	A1
fun	S2
ambitious	A1
provide first line support to our team of colleagues	S4
reporting directly to the head of team experience	S4
overseeing hr administration	S4
maintaining hr records	K04
compiling hr data	K04
running reports	S4
managing hr processes	S4
hr best practices	S4
processes	S4
policies	K04
employment law	A1
organisation	K04
attention to detail	A1
positive	A1
professional	A1
communication	K04
literacy	K02
numeracy	K02
it skills	S1
willingness to develop	A1
line management	K04
level 5 cipd	S1
Kronos	A1
maximising sales	K04
building a highly engaged and high performing team	S4
leading from the front	S4
hands-on approach	A1
inspire your team	A1
inject fun into the work place	S4
create a truly amazing place to work	S4
delivers an exceptional standard of customer service	S3
pet knowledge	A1
deliver the highest standards of pet care	S4
ensure that the welfare of pets is a top priority	S4
promoting responsible pet ownership	S4
motivating training and developing your team	S4
running a store	S4
achieving and exceeding key store targets	S4
communicate effectively to your team	A1
take full responsibility for the store	A1
involved in absolutely everything in your store	A1
recruitment	K04
stock control	S4
store standards	S4
retail	K02
pets!	S4
supervisory/management	K04
hands-on approach	A1
delivering high standards!	S4
people person	A1
team player	A1
communication	K04
engage and inspire a team	A1
proactive	A1
customer focused	A1
recording of events and service failures	S4
chasing and completion of calls	S4
production of work request failures	S4
liaising with internal team and external contractors	S4
maintenance of records of live and paid works	S4
kpi's	S4
SLA's	S4
raising purchase orders	K04
completion of worksheet upload spreadsheet	S4
cafm system administration	K04
assisting the helpdesk manager	S4
general office administration duties	A1
reporting	K04
provide minutes of meetings	S4
contract administration	K04
ensure the helpdesk operates professionally	S4
manage the lines of communication	S4
achieve a high degree of customer and supplier satisfaction	S4
achieving key performance indicators ( kpis	S4
customer service	K10
system knowledge	K04
operate a helpdesk function across multiple sites	S4
accurately record details of the caller problem and severity	S4
ensure that the service centre manager is aware of situations which could develop into issues	S4
work within and to processes and procedures	A1
respond quickly and efficiently to all requests	A1
attention to detail	A1
obtaining and inputting information	K09
clear and professional telephone manner	A1
achieve a high degree of customer and supplier satisfaction	S4
applying logic and common sense	S4
ensuring that identified criteria are escalated	S4
scheduling ppm remedial and reactive work	K04
jeopardy management	K04
escalation of planned and responsive works	S4
monitor and optimise the utilisation of engineer activities	S4
scheduling of works	S4
raising purchase orders	K04
run reports	S4
show outstanding work orders	S4
attend training and coaching sessions	S4
identify any potential areas of improvement	S4
flexible	A1
adaptable	A1
highlight any training needs and development	S4
operating a facilities management helpdesk	S4
call centre service	K10
developing productive working relationships	S4
qfm helpdesk system	S4
computer hardware	K07
peripherals	K09
applications	K10
networks	K10
shared files and folders	S4
report creation	K04
keyboard skills	S4
focusing on client & customer	S3
delivering stretched results	S4
act collaboratively	A1
intellectual agility	K04
willingness to learn	S4
computer databases	S4
nvq level 2 or 3	K09
customer service	K10
call handling	A1
working with and developing kpiâ€™s and measurement information	S4
rsa level i keyboard skills	S1
european computer driving licence ( ecdl ) level i	S4
microsoft word	S1
microsoft excel	K06
level 2 & 3 nursery	K09
providing care and educational support	S4
pms	S1
reservation systems	K02
customer service?	K10
organised analytical approach	K04
numerical skills	S1
pms	S1
reservation systems	K02
timekeeping	A1
work calmly in a high-pressure environment	S4
english	L1
making reservations	S4
ensuring that all enquiries receive a prompt response	S4
all correspondence is accurately filed	S4
log failures	K04
convert a booking	K04
monitor non-arrivals and late cancellations	S4
run daily arrival checks	S4
ensure all reservations are correct	S4
work with others	S4
improve our customer service	S4
cover reception	S4
monitoring and recording key data	S4
keeping the pms up-to-date	S4
ensure that market segmentation rates and guest information are accurately recorded	S4
helping the hotel to achieve its financial targets	S4
upsell	A1
escalate/communicate about any new sales leads	S4
contribute to pricing decisions	S4
highlighting if availability is changing	S4
rate strategies should be reviewed	S4
pms	S1
reservation systems	K02
organised	K01
analytical	A1
customer service	K10
commercial awareness	K04
corporate tax	K10
personal tax	A1
vat	S2
ACCA/ACA/ATT	S4
cta	K09
supporting and training the more junior member of staff	S4
manging	K09
supervising	S4
coaching	K09
mentoring	K09
work with a varied portfolio	A1
provide compliance and advisory services	S4
support clients	S4
services in corporation tax and personal tax	S4
work in a varied capacity	A1
confident	K10
professional	A1
ambitious	A1
tax planning	K04
advisory work	A1
tax computations and reviews	S4
capital gains tax	K10
trusts	A1
inheritance tax/wills	S4
property tax	K10
corporate tax planning	K04
mergers & acquisitions	S4
restructuring	K04
investments	K02
dealing with a variety of high net worth individuals partnerships directors tax omb	S4
manage the team	S4
planning and reviewing work in progress	S4
supporting the directors	S4
providing direction to the team	S4
lead and grow the department	S4
business development	K04
selling services	K04
CIMA	K02
help residents enjoy each day	S4
assist with daily living	S4
providing support and companionship	S4
dedication	A1
compassion	K04
supporting residents with their food and drink	S4
following care plans	S4
caring for older people	S4
can-do approach	A1
communication skills	S1
empathy	A1
warm-hearted approach	K09
compassion	K04
deliver the highest standard of care and support	S4
drive expansion	S4
exceed monthly / quarterly sales targets	S4
driving new opportunities	S4
exceed monthly / quarterly sales targets	S4
driving new opportunities	S4
analyse your industry territory	S4
identify prioritise and segment accounts	S4
collaborating	K04
create demand	S1
cold calling	S4
email / social campaigns	K10
supporting other business development activities	S4
engage your extended team	A1
engage with prospect organisations	S4
strategic value-based selling	K04
business case definition	K04
return on investment analysis	S4
references	K09
analyst data	S1
engage with customer cios and cfos	S4
converse with senior technologists	S4
generate short term results	S4
maintaining a long term perspective	S4
maximize overall revenue generation	A1
provide accurate monthly forecasting and revenue delivery	S4
build and maintain a territory pipeline of business	S4
selling enterprise software	K04
PaaS	S4
IaaS	S1
saas	S4
net direct new business sales	K04
consistent delivery against targets	S4
strong customer care	A1
helping to ensure customer success	S4
credibility	A1
building strong relationships internally and with the customer	S1
selling industry-specific use cases / technologies	S4
CPG	K02
manufacturing	K04
services	K02
iPaaS	S1
api management	K04
automation	K02
bpm	K02
deliver key business outcomes	S4
bachelorâ€™s degree	K01
full driving license	S4
internal framing work	S4
finishing work	A1
skirtings	S7
facings	K09
cscs card	K09
carpentry	A1
CSCS	K01
electro/mechanical assembly	K04
hand assembly	A1
wiring electronic sub-assemblies	S4
mechanical assembly	K04
working to customer specifications	S4
can do attitude	A1
driving	S4
strategic planning & governance	K04
strategic planning	K04
performance reporting	K04
strategic planning	K04
corporate performance	K04
manage the strategic planning and corporate performance reporting functions	S4
manage the strategic and operational planning process	S4
support senior colleagues	S4
completing plans	S4
provide specialist advice	A1
guidance	A1
support to managers staff and the public	S4
strategic planning	K04
corporate performance	K04
conduct stakeholder consultation/engagement	S4
engage with internal and external groups and networks	S4
development or expansion of good practice	S4
strategic planning	K04
corporate performance	K04
coordinate the preparation of an annual report	S4
ensure the annual report complies with the government financial reporting manual ( frem	S4
government financial reporting manual ( frem	K04
analytical decision making	K04
communication skills	S1
maintain positive relationships	S1
seek information and co-operation	S4
conduct trend analysis on complex data sets	S4
working with stakeholders	S4
inform of any discrepancies variances and trends	S4
scqf level 9	K09
technology	K02
project manage	K04
bridge the gap	K01
liaising with many stake holders	S4
influencing and negotiation skills	S4
prince2 practitioner qualification	K04
msp qualification	K04
project management	K04
change management	K04
benefit realisation	K04
workforce redesign	K04
energetic	A1
work independently as well as in a team	A1
persistent	A1
sales	K10
B2B	K04
concept sales	K10
business	K09
english	L1
french	S4
german	S2
java	K02
working in the web layer	S4
working as a key member of an agile team	A1
frequent delivery	A1
end-to-end application ownership	K04
contributing to a cross functional agile team	S4
elaboration development and testing of user storiesÂ•	S4
sprint planning	K04
backlog grooming	K04
task estimationÂ•	K04
development and modification of frameworks common components and business componentsÂ•	S4
development of unit tests	S4
contribution to the creation of automation in higher levels of the test pyramidÂ•	S4
refactoring code	K09
contribution to code quality improvementsÂ•	S4
development standards	S4
best practices	S4
software development	K04
review of colleagueÂ’s codeÂ•	S4
progressive development behaviours	K04
maximizing collaboration	S4
knowledge sharing	S4
effective pairing	A1
creation of pocÂ’s / spike development	S4
involvement in technology evaluation	K04
work and communicate across geographical and cultural borders	S4
build a strong professional network	S4
participation in the elaboration of user stories	S4
agree stories are sufficiently described	S3
quality design and implementation	K04
ensuring builds are kept green	S4
code management strategy ( branching ) is closely	S4
raising capability and standards	S4
pairing on tasks	S4
peer review of team membersÂ’ code	S4
constructive feedback for improvement	K04
proactive contribution to continual improvements	S4
active participation in retrospectives	S4
engagement with cross team bestpractice	A1
support product owner	A1
identify and manage risks debt issues and opportunities	S4
support the recruitment activities	S4
technical support	K02
technical support	K02
implementation skills	K09
java	K02
SpringBoot	A1
unit testing	K09
development	K02
agile	A1
integration of testing into development workflow	S4
test frameworksÂ• build tooling	S4
maven)Â•	S1
work in ui	A1
continual delivery pipeline tools	S4
jenkins	A1
ansible	K09
communication skills	S1
articulate clearly to technical team members	S4
work with product owners	S4
collaborative	K09
critical reasoning	K09
problem solving	A1
agile software development	S4
xp	K02
BDD	S1
TDD	A1
fast turnaround development	S4
continuous delivery	A1
service orientated	A1
microservice architectureÂ•	K04
shared-nothing architecture	K04
domain driven design	K04
bounded contextÂ•	S4
high volume transactional systemsÂ•	S7
api gateway	S4
Akana	A1
coherent software architecture and designÂ•	K04
message or event based architecturesÂ•	S4
eventual consistency concepts	K10
contributor to open source projects	S4
mechanical understanding	K04
automation	K02
process optimization	K04
support and problem-solving	K04
decanters	S4
high-speed separators	K09
putting put the customer first	S4
preventive maintenance of supplied equipment and machines	S4
repair and service according to customer requirements	S4
support to customers	S4
general technical support	S4
adjustments to equipment and machines	S3
start-up and commissioning of machinery	S4
process plants on board vessels	S4
training of the crew	S4
optimization of plant and equipment	S4
decanters	S4
high-speed separators	K09
PureBilge	S4
FWG	K04
pure	K09
marine business	K02
sailing	A1
mechanical understanding	K04
automation	K02
control systems	K02
microsoft office	A1
danish	S2
english	L1
developing our new data backbone	S4
inspiring the stakeholders	S4
advanced analytics	K04
artificial intelligence	K04
extracting insights and value from data	S4
applying domain expertise	S4
ensure data collection procedures	K04
building analytic systems	K04
operationalise data mining and analysis into business applications	S4
maintain the productionised models	S4
quantitative or data-heavy functions	S4
c#	A1
python	A1
java	K02
open source data ingestion tools	S4
nifi	K09
cloud platforms	K04
container technology tools	S7
analytics engines	K04
spark	S2
Databricks	S4
data visualisation tools	S4
cloud platforms	K04
machine learning	K04
algorithms	S4
willingness to learn	S4
criminal record certificate	K09
criminal record certificate	K09
criminal record certificate	K09
registering and controlling goods	S4
picking and packing	K04
preparing pallets	S4
loading and unloading lorries	S4
operating a forklift	S4
forklift license	K04
independently	A1
proactively	A1
set high standards	S4
flexible	A1
helpful	A1
developing and applying new optical microscopy techniques	S4
intestine	A1
biopharmaceuticals	S4
reinvent our research strategies	S4
constructing a 'light sheet' fluorescence microscope	S4
live-sample imaging	S4
3d printed organoids	K02
pursue a deeper understanding	S4
implementing one of the worlds most advanced optical microscopes	S4
use the microscope	S4
capture how fluorescently labelled biopharmaceuticals travel through the intestinal barrier	S4
optimizing microscope hardware and software	S4
provide the best images	S4
drive hardware/software development	S4
document present and publish scientific findings	S4
contribute to the enjoyable and collaborative work environment	S4
master's degree	K01
work independently	A1
prioritize tasks	S4
plan and execute complex hardware implementation	S4
interface optics	K10
electronics	K10
software	K02
work constructively in a team	A1
analyse	K04
contribute	K04
solve biological/mathematical challenges	S4
use software for instrument control	S4
labview	A1
use software for data simulation	K04
basic image analysis	K04
matlab	K02
use software for basic mechanical design	K04
SOLIDWORKS	S7
communicate professionally	A1
english	L1
present insights progress and bottlenecks	S4
european code of conduct for research integrity	S4
software/hardware development	K10
fundamental biology/physiology	K09
bsc/msc diploma	K09
research	K02
teaching	K04
marketingÂ—in	A1
business	K09
development	K02
active engagement	A1
strengthen the relationship	S1
initiate and participate in external funding	S4
sustained record of research publications	K09
research management	K04
teaching	K04
provide dynamic leadership	S4
teaching	K04
research dissemination	K04
working with business and society	S4
undertaking research	K04
teaching practice	K04
dissemination	K09
business research	K04
research management	K04
initiation of research projects	S4
supervision of ph.d	K09
international research co-operation	K04
journal editorship	K04
reviewing for academic journals	S4
academic development	K02
marketing	K02
research-based teaching	K04
supervision	S1
examination	K04
teaching on business research	S4
course and program development	K04
promotion	K04
participation in and possibly initiation of externally funded research projects	S4
contribution to the administrative responsibilities	S4
dissemination of research findings	S4
participation in the departmentÂ’s regular research activities	S4
engagement in and contribution to academic citizenship activities	S4
participate actively in the research and teaching activities	S4
maintain and establish broad links	S4
record of research	K04
teaching	K04
research management	K04
research	K02
teaching	K04
business research	K04
provide dynamic leadership	S4
development of research	S4
teaching	K04
research dissemination	K04
working with business and society	S4
achieving ) research grants	S4
pedagogical qualifications	K04
development and innovation in the pedagogical area	S4
english	L1
teaching qualifications	S4
teaching evaluations	K04
love being outdoors	S4
create an entertaining & memorable tour	S4
share your knowledge?	A1
responsible and professional work ethic?	A1
providing fun informative and engaging tours	S4
know all information provided	A1
run tours on time	S4
provide extensive information about the city	S4
answering customer questions	S4
show independent thinking	A1
professonal approach	A1
leadership	K04
assiting with teambuilding excercises	S4
leading	K04
meticulous	A1
detail-oriented	S4
ensure the shop is tidy and clean	A1
dusting	K01
vacuuming	K09
set up for your customers	S4
independent work approach	A1
street-marketing	K04
street-marketing	K04
approaching people	S4
confident	K10
engaging	K04
english	L1
german	S2
danish	S2
lively	K01
fun	S2
public speaking	K04
engage an audience	S4
responsible	A1
dutiful	A1
mature	S2
demonstrate leadership abilities	S4
service-minded	A1
providing a first-class experience	A1
perform at your best ability	S1
high-school diploma	K01
bachelor/post-graduate degree	K01
danish	S2
english	L1
service-industry	A1
tourism	K09
social media marketing	K04
sales	K10
Segways	A1
first-aid skills	S1
stamina	K09
love for being outdoors	S4
supply chain	K04
manage challenges	K04
business acumen	S4
planning skills	S1
collaborating	K04
ensure reliable supply	K04
operating in a structured formal monthly sales and operations planning process	S4
sales and operations planning process	S4
maximize product availability	S2
standardized global processes	S4
sap	K06
optimize supply and inventory plans	S4
lead supply scenario analysis	K04
monitor supply and capacity performance	K04
coordinate supply and capacity bottleneck management	S4
support the supply risk management process	S4
respond to ad hoc requests	S4
establish and develop a close collaboration	A1
planning	K04
masterÂ’s degree	K01
business	K09
engineering	K04
supply chain management	K04
supply chain	K04
sap apo	K06
providing ideas and input for optimization	S4
handle hands-on planning tasks	S4
complex coordination	K04
overview	K04
sense of detail	S4
open-minded	A1
establish collaborative relations to people	S1
tailor your communication to your audience	S1
make people prioritize your agenda	S4
advanced electron microscopy	K10
environmental catalysis	A1
nanomaterials	K10
selective catalytic reduction ( scr ) of nox	S4
undertake atomic-scale studies	S4
situ transmission electron microscopy	K09
characterization tools	K10
surface science techniques	S3
catalyst testing	K04
synthesis	K10
develop an understanding of the catalytic performances	S4
target new designs of catalyst materials	S4
improving nox emission control	S4
experimental research	K04
scr catalysts	S4
application of s/tem and eels for atomic-resolution and in situ studies	S4
develop our atomic-scale model	S4
scr	K04
scr catalysis	A1
publishing in high-profile journals	S4
committed	A1
flexible	A1
innovative mind-set	A1
new ideas	A1
ready to face new challenges	S4
take responsibility	A1
execute and communicate complex research goals	S4
enthusiastic	A1
catalysis sciences	K01
Ph.D	K09
physics	A1
chemistry	A1
high-resolution ( scanning ) transmission electron microscopy ( s/tem	S4
heterogeneous catalysts	S4
solid-state nanomaterials	K02
audio engineering	K04
acoustic design	K02
algorithm trimming	K09
sound quality evaluation	K04
passion	A1
creativity	K04
work on new algorithm concepts	S4
directionality/beam-forming	S4
trimming and verification of various audio algorithms	S4
audio engineering	K04
msc	K09
outgoing	K04
getting things to move forward	S3
inspires your colleagues	S4
dealing with many stakeholders	S4
setting a direction	S4
english	L1
audio engineering	K04
algorithm concepting	K10
directionality	K04
beam-forming	S7
matlab	K02
python	A1
trimming of various audio algorithms	S3
noise reduction systems	K04
eq	A1
compressors	A1
objective and subjective sound quality evaluation	S4
measurement systems for audio evaluation	S4
soundcheck	A1
head acoustics acqua audio analyzers	S4
communicating technical issues	K04
research the market	K01
take initial contact to potential clients	S4
carry out market research of potential clients	S4
establish initial contact to potential clients	S4
translate sales material	S1
english	L1
italian	A1
italian	A1
english	L1
tele marketing	K04
proactive on the phone	A1
independent	A1
positive	A1
proactive	A1
danish	S2
working in a sales department	S4
leading technology strategy roadmaps and transformation plans	S4
communication	K04
integration	K09
PLM/PDM	S4
manufacturing execution	K04
product quality systems ( qsys	K04
global erp ( sap ) platforms	K10
dynamic	A1
personal motivation	A1
drive	A1
approach complex tasks	S4
open mind	A1
focus	S2
providing the best solution	S4
structured	S7
analytic	A1
lead the technology roadmap	S4
participate actively in strategic projects	S4
PLM	K01
main interface between plm data and systems governance organizations	S4
lead and coach a team	S4
PLM	K01
model and control enterprise plm architecture ( data and systems	K04
TOGAF	K02
asses value propositions of project proposals	S4
Teamcenter	S1
PLM	K01
how systems interact with erp	S4
manufacturing execution systems	K04
PLM	K01
erp systems	K04
capturing requirements from large organizations	S4
architecting value creating solutions for the business	S4
enabling the software to create value	S4
processes	S4
lifecycles	S4
wind turbine	K04
communicate on all levels	S4
persuasive communicator	K04
english	L1
teaching	K04
research	K02
basic and applied nutrition of ruminants	S4
dairy cattle	A1
dairy production	S7
data modelling	K04
evaluation of feed quality and feed intake in dairy cattle	S4
nordic feed evaluation system	K04
NorFor	A1
dairymanagement system	K04
feed evaluation	K04
digestive processes	S4
intermediary metabolism	K09
impact of nutrition and feeding management	S4
animal health	K09
product quality	K04
research	K02
publication/academic dissemination	K04
research-based teaching	K04
examination	K04
sharing knowledge with society	S4
phd degree	K01
research	K02
teaching	K04
enterprising	K04
interpersonal skills	S1
information technology	A1
java	K02
algorithm	A1
database	K02
multithreading	K04
concurrency	A1
solve technical challenges	S4
deliver high quality code	A1
build and ship new features	S4
write high quality testable and efficient code	A1
promote new ideas	S4
take active part in features discussions and roadmap prioritisation	S4
integrate cutting edge research and technologies	S4
work closely with our customers and other teams	S4
developing production level software	S4
designing multi-threaded systems and algorithms	S4
system design	K04
data structures	K04
algorithms	S4
java	K02
troubleshooting	K04
performance profiling	K04
optimisation	K04
development methodologies	K09
care about code quality	K09
communication skills	S1
sense of humor!	A1
eCommerce	K10
price comparison	K10
online portal	K04
.net	K02
agile	A1
rest	S2
microservices	S4
eCommerce	K10
price comparison	K10
online portal	K04
.net	K02
agile	A1
rest	S2
microservices	S4
development test and deployment of new components	S4
transition	K04
re-engineering	K04
design	K02
extension	S2
continuous integration	K04
continuous deployment	K04
.net	K02
micro services	K02
development and implementation of rest api's	S4
web and/or e-commerce	K04
agile method practice	K04
english	L1
german	S2
data science	A1
it security	K02
software development / engineering	K04
java	K02
rest	S2
cloud	K02
spring	S2
design-patterns	K04
data science	A1
it security	K02
software development / engineering	K04
java	K02
rest	S2
cloud	K02
spring	S2
design-patterns	K04
enthusiasm	A1
professional attitude	A1
work together closely with product owners and colleagues	S4
develop an in-depth understanding of the domains and the requirements	S4
happy to share your valuable insights	S4
offer them professional advice	A1
share your knowledge	A1
advise individual colleagues	S4
software development	K04
agile project team	S4
java stack frameworks	K04
quality	K02
testing at various levels in an agile environment	S4
test automation	K10
clear easy-to-maintain code	A1
latest technologies	S4
back end development	K02
databases	K09
cloud computing	K04
restful api	K09
big data	A1
devops	K02
build implement and operate a system	S4
architecture concepts	K10
design patterns	K04
german	S2
english	L1
digital agency	K04
software development / engineering	K04
user experience	A1
javascript	K02
angular	K02
reactjs	A1
vue.js	K02
typescript	K04
digital agency	K04
software development / engineering	K04
user experience	A1
javascript	K02
angular	K02
reactjs	A1
vue.js	K02
typescript	K04
develop attractive state-of-the-art user interfaces	S3
application architecture	K04
api design	K04
implementation of functionality	S4
code reviews	S4
technical advice for our customers	S4
guidance and support for your teammates	S4
realize exciting projects	S4
degree in computer science	K01
javascript/typescript	K02
angular	K02
react	A1
vue	K09
architecture of complex single page applications	S4
accessibility	A1
usability	K04
current web standards	S4
code quality	K04
clean code	A1
quality and responsibility	A1
eye for aesthetics design	K10
faithful implementation	K04
german	S2
english	L1
financial services	K04
financial technology	K04
regulatory reporting	K04
c#	A1
typescript	K04
.net-core	K02
less	K09
sql-server	K02
financial services	K04
financial technology	K04
regulatory reporting	K04
c#	A1
typescript	K04
.net-core	K02
less	K09
sql-server	K02
deliver software solutions	K04
creation of programs	S4
configuration/customisation of platforms	S4
capture & analysis of requirements	S4
requirements capture/analysis and documentation	K09
design ( and documenting ) of own solutions	S4
writing software	K04
configuring software platforms	S4
troubleshooting	K04
debugging code	K04
testing	K09
analysis of test results	S4
documentation	K04
microsoft	K06
web development	K02
c#	A1
.net core	K02
.net framework	K02
sql	K02
sql server	K02
typescript	K04
javascript	K02
asp.net	K02
Blazor	K04
javascript	K02
JQuery	K02
angular	K02
react	A1
vue	K09
html5	K02
css ( less	S1
Bootstrap	K02
troubleshooting it infrastructure related issues	S4
microsoft-based development environment	K04
microsoft certifications	S4
team player	A1
methodical and reliable approach	A1
problem solving	A1
financial services	K04
communication skills	S1
java	K02
testing	K09
web-services	K04
java	K02
testing	K09
web-services	K04
solving business problems	S4
innovation & engineering practices	K04
apply your depth of knowledge and expertise	A1
software development lifecycle	K10
partner continuously with your many stakeholders	S4
stay focused on common goals	S4
creating api services	S4
work closely with colleagues and the business	S4
functional and non-functional requirements	S4
drive the design and implementation of well tested easily supportable scalable and robust solutions	S4
bs/ba degree	K01
deployment approaches	S3
considerations	K10
managing deployments	S4
industry wide technology strategies	S4
best practices	S4
work in large collaborative teams	S4
achieve organizational goals	S4
building an innovative culture	S4
java ( version 8 or higher	K04
spring boot	A1
performance testing	K04
unit testing	K09
integration testing	K04
behavioural testing frameworks	K04
mocking frameworks	K04
continuous integration	K04
designing applications	S4
high throughput mission critical high performance stp platforms	S4
designing and building reusable services	S4
support the developers in your team	S4
leading	K04
supporting	K04
coaching	K09
application delivery	A1
stakeholder management	K04
oracle	K02
cloud services	K04
information technology	A1
technology consulting	K04
.net	K02
microsoft-dynamics	S4
dynamics-365	K02
cloud services	K04
information technology	A1
technology consulting	K04
.net	K02
microsoft-dynamics	S4
dynamics-365	K02
developing	K04
development	K02
customisation	K10
configuration	K04
development of plug-ins	S4
c#	A1
work with business product owners and business analysts	S4
elicit requirements	A1
assist in developing design specifications	S4
maximise the benefit	S4
collaborate with other stakeholders/ end users	S4
software development lifecycle	K10
design	K02
development	K02
delivery	A1
dynamics 365	A1
dynamics crm	K04
dynamics 365	A1
.net	K02
ms dynamics 365	A1
technical aptitude	K02
providing extraordinary customer service influence impact	S4
problem-solving	A1
building customer and partner relationships	S4
microsoft stack	S4
dynamics 365	A1
scrum/agile	S4
sc clearance eligible	K09
.net webapi	K02
sharepoint	K02
vehicle tracking	K04
azure	K02
.net	K02
c#	A1
azure-cosmosdb	K04
rest	S2
vehicle tracking	K04
azure	K02
.net	K02
c#	A1
azure-cosmosdb	K04
rest	S2
development cycle	K10
analyzing	A1
deciding the best approach	A1
write code	A1
design patterns	K04
unit tests	K09
design	K02
write code	A1
.net	K02
modify .net services and apis	K02
apis	K02
maintain strong backend code quality	S3
c#	A1
.net framework	K02
.net core	K02
t-sql ( ms sql server	K04
object-oriented design	K04
restful services	K09
azure storage	K04
azure eventhub	K04
azure functions	K04
azure data lake	K04
azure cosmosdb	K04
security principles	S4
computer science	K02
engineering	K04
teamwork	A1
attention to detail	A1
resourceful	K04
problem solving	A1
communication skills	S1
english	L1
qa	K09
automation	K02
testing	K09
qa	K09
automation	K02
testing	K09
delivering real quality	S4
planning test activities for each build cycle	S4
testing client configurations	S4
reporting the results	S4
incorporating that testing into automation	S4
reporting and documenting issues found	S4
following up on issues raised	S4
communicator	K04
connect together complex issues	S4
appreciate quality	K04
testing	K09
automation	K02
complex system	S4
code	S2
financial services	K04
qa	K09
python	A1
automation	K02
financial services	K04
qa	K09
python	A1
automation	K02
automation	K02
functional testing	S4
regression/reconciliation	K09
new feature testing	S4
continuous delivery	A1
end to end automated testing	K09
data integrity	K04
performance	K02
presentation quality	K04
software development	K04
automate end to end test requirements	K09
java/python	K02
schedule and execute regression cycles	S4
execution of non-functional regression testing	S4
ensure the resiliency and performance of the system	S4
operational processes	S4
provide solutions	S4
improve operational efficiency	K04
agile	A1
participating in sprint planning backlog refinement	S4
retrospectives	S4
defect management	K04
of test coverage	K04
identify gaps	K10
provide improvements	S4
it/quality assurance	K04
bachelor's degree	K01
computer science	K02
quality assurance	K04
testing arena	K09
quality assurance methods/processes	K04
lifecycle principles	S4
quality assurance processes	K04
automated testing	K09
java	K02
python	A1
testing of mainframe	S4
test automation frameworks	K04
communicate	K04
work under pressure	A1
resolve issues affecting the production services	S4
detail oriented	A1
work independently	A1
core java	K02
unix scripting	K04
sql	K02
continuous integration ( ci	S4
git	A1
jenkins	A1
mainframe/ibm iseries	K04
iseries menu/end of day	A1
read/publish on message	S4
financial services	K04
cloud	K02
java	K02
amazon-web-services	K04
financial services	K04
cloud	K02
java	K02
amazon-web-services	K04
solving business problems	S4
innovation and engineering practices	K04
apply your depth of knowledge and expertise	A1
software development lifecycle	K10
partner continuously with your many stakeholders	S4
stay focused on common goals	S4
bs/ba degree	K01
core java	K02
spring boot	A1
Microservices	S4
AWS	K02
Kubernetes	S4
Docker	K04
Spinnaker	A1
devops	K02
ci/cd automation	K02
application data and infrastructure architecture disciplines	K04
industry-wide technology trends and best practices	S2
work in large collaborative teams	S4
achieve organizational goals	S4
building an innovative culture	S4
business analysis	K04
development	K02
maintenance	K04
software improvement	K04
artificial intelligence	K04
machine learning	K04
translation	S1
node.js	K02
javascript	K02
nestjs	A1
artificial intelligence	K04
machine learning	K04
translation	S1
node.js	K02
javascript	K02
nestjs	A1
design and develop a micro-service architecture	S4
gather understand and prioritize requirements	A1
research potential solutions	K04
rapidly build prototypes	S4
distill and communicate what was learned expected risks necessary resources	S4
security concerns	K10
provide high-level technical design	S4
strategy roadmap development	K04
technical architecture	K04
assure that our architectures are consistent	S4
industry best practices	K10
scalability	K04
availability	K04
maintainability	K04
flexibility	A1
communicate strategies and processes	S4
select the best talent to join	A1
onboard new colleagues	S4
javascript	K02
typescript	K04
node.js	K02
NestJS	A1
writing highly tested software	S4
unit testing	K09
integration	K09
defining and modelling a consumable api	S4
work autonomously	A1
energized by missions and goals	S4
designing	K04
analyzing	A1
optimising code	A1
troubleshooting large-scale distributed systems	S4
python	A1
django	A1
docker	K04
orm	S2
sqlalchemy	K09
python	A1
django	A1
docker	K04
orm	S2
sqlalchemy	K09
lead the design & implementation	S4
back-end services	K10
drive the implementation of new forecasting algorithms and tooling	S4
responsibility for live productions systems	S4
perform developer tests	K09
peer code reviews	S4
prepare strong documentation	A1
develop tools	S4
improve and maintain components & systems	S4
python	A1
back-end programming	K04
database structures	K04
webapp design	K04
python	A1
orms	S1
Django	A1
ORM	S2
SQLAlchemy	K09
designing & implementing distributed system architectures and apis	S4
docker	K04
deploy your applications	S4
computer engineering	K04
manage individual priorities deadlines and deliverables	S4
contribute to engineering efforts	S4
solve complex engineering problems	S4
get-things-done attitude	A1
identify shortcomings quickly	K09
statistical modeling	K04
optimization problems	S4
work with many different stakeholders	S4
english	L1
eu/efta or swiss work permit	A1
information technology	A1
online travel	K09
java	K02
web-services	K04
python	A1
distributed-system	S4
amazon-web-services	K04
information technology	A1
online travel	K09
java	K02
web-services	K04
python	A1
distributed-system	S4
amazon-web-services	K04
java	K02
python	A1
Docker	K04
AWS	K02
hadoop/spark	K02
sql	K02
airflow	K10
Jupyter	A1
agile/lean	S4
base your decisions on solid data and metrics	S1
produce outstanding work	S4
break challenges into bite-size tasks	S4
mentor team mates	A1
demand quality	K04
machine learning	K04
cloud services	K04
apis	K02
developing a whole range of key product features	S4
defining and implementing services	S4
collaborate with product engineers	S4
accountable for your own projects	S4
trusted to deliver	A1
form part of a broader team	A1
takes collective responsibility	S4
making success happen	S4
mobile application	K04
android	S2
mobile	S2
kotlin	A1
architect	K04
build	S4
maintain	K02
tackle challenges	S4
find creative ways to implement new features	S4
Kotlin	A1
RxJava	A1
Couroutines	A1
share your knowledge	A1
keep up the high level of quality	A1
reviews	S4
pairing	S4
mentoring	K09
focus on a top-notch user experience	A1
make the app context aware	S4
google awareness api	K02
improve of our sync framework	S4
build features	S4
location based services	S4
design	K02
ui	K02
ux	K02
mobile technologies	S4
mobile wallets	S4
android sdk	K09
coding	K04
Kotlin	A1
solving technical challenges	S4
ios app	K02
backend development	K02
degree	K01
computer science	K02
android	S2
payment	A1
loyalty	A1
shopping	K02
eCommerce	K10
internet marketing	K02
java	K02
spring	S2
node.js	K02
reactjs	A1
high-quality well-tested and scalable code	S4
ensure code quality and maintainability	S2
evolving architecture and tech stack	S4
code reviews	S4
refactoring	K10
standards	S4
improving build and test systems	S4
coach guide and mentor teams	S4
architecture	K04
technology	K02
collaborate	K04
identifying managing and minimizing technical debt	S4
share architecture knowledge findings and standard methodologies	S4
java	K02
spring framework	K02
web technologies	K04
( non- ) relational databases	S1
node.js	K02
react	A1
design implementation and operation of distributed services and apis	S4
strategic thinker	K04
analytical	A1
critical thinking	K04
frame problems	K02
drive teams	S4
collect data	K04
guide the analysis	S4
present the data	S4
influence leadership	K04
agile software development	S4
product discovery	K04
continuous deployment	K04
aspiration for quality	K04
sense of pragmatism	A1
quality assurance	K04
quick adoption of new technologies	S4
speak at conferences	S4
engage in the community	S4
english	L1
communication	K04
