questioning	S2
expressing self clearly and	A1
seek develop and secure new opportunities	A1
measure monitor and review performance of key accounts	S2
ensuring budgets and forecasts are met	S2
identify and monitor key performance and financial indicators	S2
maintain and monitor service expectations of existing and key accounts	S2
support external sales force	S4
management of business	S4
select appropriate carrier	S1
maximise freight profits	S2
manage your own time	S1
integrate and co-ordinate new business	S4
arrange regular meetings	S1
submit financial reports	K02
CIMA	K02
care deeply	S1
ever-changing environment	K02
excel	K02
shape the world of iot	S2
advocate quality	S1
verify	A1
validate	S2
analyze	K02
lower risks	A1
automate tests	S4
build great products	S1
shape the features	K02
cloud-based microservices	K02
audio/video pipelines	K02
machine learning	K01
mobile applications	S1
critical thinker	K04
user experience	S1
quality	K02
software testing	K01
curiosity	K02
resourcefulness	K02
find problems	A1
provide creative solutions	S1
software testing techniques	K02
advocate for quality in decision making	S1
tinkerer	A1
create your own apps and robots	S1
working closely with developers	S1
diligent with documenting your test plans test cases bug reports	S4
coding	K02
python	S1
java	K02
javascript	S1
Golang	A1
selenium	K04
TestCafe	S1
web	K02
api	K02
backend	K04
integration	S1
performance/load/stress	S2
security testing	K01
continuous integration	S1
continuous delivery and/or deployment	S4
jenkins	K04
CircleCI	K02
linux	K02
Docker	K04
Kubernetes	K02
web services	K02
networking	S1
distributed systems	K02
cloud services	K02
GraphQL	K04
driving?	K04
fast-paced team environment?	A1
upholding a positive brand image	S1
providing excellent customer service	S1
managing cash and card transactions	A1
delivering products safely and securely	S1
avoiding unnecessary risks	A1
safety and security procedures	K04
uk or eu driving license	K04
own car	K02
local area	K02
fast-paced environment	A1
customer service	S1
quality	K02
driving!	K04
food hygiene	S3
store cleanliness	A1
keen eye for detail	K04
day to day running of kitchen ordering and installs	S4
work closely with our installation team	S4
deliver projects efficiently	S2
maintain an impeccable level of customer service	S2
joinery	S4
kitchen industry!	K02
email	K02
organisational skills	K04
self-motivated	K04
working on their own initiative	S4
communicator	S1
kitchen industry	K02
computers	S1
attention to detail	K02
building and maintaining strong relationships	S1
multi-task	K01
deliver against deadlines	S4
valid uk driving license	K04
communication skills	S1
kitchen industry	K02
valid uk driving licence	K01
a-level	K01
support the bakery management team	S4
support the teams	S4
go above and beyond for our customers	S2
positive	A1
energetic	A1
engaging with people	S1
communications skills	S1
talented	K02
fun	A1
ambitious	K02
provide first line support to our team of colleagues	S4
reporting directly to the head of team experience	S4
overseeing hr administration	K04
maintaining hr records	K04
compiling hr data	K04
running reports	S1
managing hr processes	K04
hr best practices	S1
processes	K01
policies	S1
employment law	K01
organisation	S4
attention to detail	K02
positive	A1
professional	K02
communication	S1
literacy	K02
numeracy	S2
it skills	K04
willingness to develop	A1
line management	K04
level 5 cipd	K04
Kronos	S2
maximising sales	S2
building a highly engaged and high performing team	S4
leading from the front	K04
hands-on approach	S1
inspire your team	A1
inject fun into the work place	K04
create a truly amazing place to work	S1
delivers an exceptional standard of customer service	S1
pet knowledge	S1
deliver the highest standards of pet care	S3
ensure that the welfare of pets is a top priority	S3
promoting responsible pet ownership	A1
motivating training and developing your team	S4
running a store	S6
achieving and exceeding key store targets	S6
communicate effectively to your team	S1
take full responsibility for the store	S1
involved in absolutely everything in your store	S6
recruitment	K01
stock control	S2
store standards	K02
retail	A1
pets!	K02
supervisory/management	K04
hands-on approach	S1
delivering high standards!	K04
people person	S1
team player	A1
communication	S1
engage and inspire a team	A1
proactive	S2
customer focused	S1
recording of events and service failures	S3
chasing and completion of calls	S4
production of work request failures	S2
liaising with internal team and external contractors	S4
maintenance of records of live and paid works	S2
kpi's	K01
SLA's	S3
raising purchase orders	K04
completion of worksheet upload spreadsheet	S2
cafm system administration	K01
assisting the helpdesk manager	S4
general office administration duties	K01
reporting	S1
provide minutes of meetings	S1
contract administration	K01
ensure the helpdesk operates professionally	S1
manage the lines of communication	S1
achieve a high degree of customer and supplier satisfaction	S2
achieving key performance indicators ( kpis	S4
customer service	S1
system knowledge	S1
operate a helpdesk function across multiple sites	S1
accurately record details of the caller problem and severity	S3
ensure that the service centre manager is aware of situations which could develop into issues	S4
work within and to processes and procedures	S3
respond quickly and efficiently to all requests	S1
attention to detail	K02
obtaining and inputting information	S1
clear and professional telephone manner	S1
achieve a high degree of customer and supplier satisfaction	S2
applying logic and common sense	S1
ensuring that identified criteria are escalated	S2
scheduling ppm remedial and reactive work	S4
jeopardy management	K04
escalation of planned and responsive works	S2
monitor and optimise the utilisation of engineer activities	S4
scheduling of works	S2
raising purchase orders	K04
run reports	K04
show outstanding work orders	K04
attend training and coaching sessions	S4
identify any potential areas of improvement	S2
flexible	A1
adaptable	K02
highlight any training needs and development	K01
operating a facilities management helpdesk	K04
call centre service	S4
developing productive working relationships	S1
qfm helpdesk system	S1
computer hardware	K02
peripherals	K04
applications	K01
networks	S1
shared files and folders	S1
report creation	K02
keyboard skills	S1
focusing on client & customer	S1
delivering stretched results	A1
act collaboratively	S1
intellectual agility	A1
willingness to learn	S1
computer databases	K03
nvq level 2 or 3	S4
customer service	S1
call handling	S1
working with and developing kpiâ€™s and measurement information	S3
rsa level i keyboard skills	S1
european computer driving licence ( ecdl ) level i	K04
microsoft word	S1
microsoft excel	K02
level 2 & 3 nursery	S3
providing care and educational support	S3
pms	K01
reservation systems	S2
customer service?	S1
organised analytical approach	K04
numerical skills	K04
pms	K01
reservation systems	S2
timekeeping	A1
work calmly in a high-pressure environment	K04
english	L1
making reservations	S2
ensuring that all enquiries receive a prompt response	S1
all correspondence is accurately filed	S1
log failures	S2
convert a booking	S2
monitor non-arrivals and late cancellations	S2
run daily arrival checks	K04
ensure all reservations are correct	S2
work with others	S1
improve our customer service	S1
cover reception	S1
monitoring and recording key data	S3
keeping the pms up-to-date	S2
ensure that market segmentation rates and guest information are accurately recorded	S2
helping the hotel to achieve its financial targets	S2
upsell	K04
escalate/communicate about any new sales leads	S1
contribute to pricing decisions	S1
highlighting if availability is changing	S2
rate strategies should be reviewed	K02
pms	K01
reservation systems	S2
organised	K01
analytical	K02
customer service	S1
commercial awareness	K02
corporate tax	K01
personal tax	A1
vat	A1
ACCA/ACA/ATT	S2
cta	K04
supporting and training the more junior member of staff	S4
manging	K04
supervising	K04
coaching	K01
mentoring	K04
work with a varied portfolio	S1
provide compliance and advisory services	S3
support clients	K02
services in corporation tax and personal tax	S3
work in a varied capacity	S2
confident	A1
professional	K02
ambitious	K02
tax planning	K01
advisory work	K02
tax computations and reviews	S2
capital gains tax	K01
trusts	S1
inheritance tax/wills	S2
property tax	S2
corporate tax planning	K01
mergers & acquisitions	S1
restructuring	K04
investments	K02
dealing with a variety of high net worth individuals partnerships directors tax omb	S1
manage the team	S4
planning and reviewing work in progress	S2
supporting the directors	K02
providing direction to the team	S4
lead and grow the department	S4
business development	K01
selling services	K02
CIMA	K02
help residents enjoy each day	S2
assist with daily living	S3
providing support and companionship	S1
dedication	K02
compassion	S1
supporting residents with their food and drink	S1
following care plans	K02
caring for older people	S1
can-do approach	S1
communication skills	S1
empathy	S2
warm-hearted approach	K04
compassion	S1
deliver the highest standard of care and support	S3
drive expansion	K04
exceed monthly / quarterly sales targets	S2
driving new opportunities	S1
exceed monthly / quarterly sales targets	S2
driving new opportunities	S1
analyse your industry territory	K02
identify prioritise and segment accounts	S2
collaborating	S1
create demand	K02
cold calling	S1
email / social campaigns	S1
supporting other business development activities	S4
engage your extended team	A1
engage with prospect organisations	S4
strategic value-based selling	A1
business case definition	S1
return on investment analysis	K04
references	K02
analyst data	K01
engage with customer cios and cfos	S1
converse with senior technologists	S1
generate short term results	K04
maintaining a long term perspective	K04
maximize overall revenue generation	K04
provide accurate monthly forecasting and revenue delivery	S2
build and maintain a territory pipeline of business	A1
selling enterprise software	S1
PaaS	S2
IaaS	S2
saas	K04
net direct new business sales	S1
consistent delivery against targets	S4
strong customer care	S1
helping to ensure customer success	S1
credibility	A1
building strong relationships internally and with the customer	S1
selling industry-specific use cases / technologies	S1
CPG	K02
manufacturing	L1
services	K02
iPaaS	S2
api management	K04
automation	K02
bpm	K01
deliver key business outcomes	S1
bachelorâ€™s degree	K01
full driving license	K04
internal framing work	K04
finishing work	K04
skirtings	S1
facings	K04
cscs card	K04
carpentry	K04
CSCS	K01
electro/mechanical assembly	K04
hand assembly	K04
wiring electronic sub-assemblies	K04
mechanical assembly	K04
working to customer specifications	S1
can do attitude	A1
driving	K04
strategic planning & governance	S1
strategic planning	K04
performance reporting	S2
strategic planning	K04
corporate performance	K02
manage the strategic planning and corporate performance reporting functions	S4
manage the strategic and operational planning process	S4
support senior colleagues	S1
completing plans	K02
provide specialist advice	K02
guidance	S1
support to managers staff and the public	S1
strategic planning	K04
corporate performance	K02
conduct stakeholder consultation/engagement	S1
engage with internal and external groups and networks	S1
development or expansion of good practice	S1
strategic planning	K04
corporate performance	K02
coordinate the preparation of an annual report	S2
ensure the annual report complies with the government financial reporting manual ( frem	K04
government financial reporting manual ( frem	K01
analytical decision making	K04
communication skills	S1
maintain positive relationships	S1
seek information and co-operation	S1
conduct trend analysis on complex data sets	K04
working with stakeholders	S1
inform of any discrepancies variances and trends	S2
scqf level 9	K04
technology	K02
project manage	K01
bridge the gap	S1
liaising with many stake holders	S4
influencing and negotiation skills	S2
prince2 practitioner qualification	S2
msp qualification	K01
project management	S4
change management	K02
benefit realisation	K02
workforce redesign	K02
energetic	A1
work independently as well as in a team	A1
persistent	A1
sales	K02
B2B	K04
concept sales	K02
business	K02
english	L1
french	L1
german	L1
java	K02
working in the web layer	S1
working as a key member of an agile team	S4
frequent delivery	S1
end-to-end application ownership	S1
contributing to a cross functional agile team	S4
elaboration development and testing of user storiesÂ•	S1
sprint planning	K04
backlog grooming	K04
task estimationÂ•	S2
development and modification of frameworks common components and business componentsÂ•	S1
development of unit tests	S4
contribution to the creation of automation in higher levels of the test pyramidÂ•	S4
refactoring code	S2
contribution to code quality improvementsÂ•	S1
development standards	K01
best practices	S1
software development	K02
review of colleagueÂ’s codeÂ•	S2
progressive development behaviours	S2
maximizing collaboration	S1
knowledge sharing	S1
effective pairing	K04
creation of pocÂ’s / spike development	S3
involvement in technology evaluation	S2
work and communicate across geographical and cultural borders	S1
build a strong professional network	S1
participation in the elaboration of user stories	S1
agree stories are sufficiently described	S1
quality design and implementation	K02
ensuring builds are kept green	S2
code management strategy ( branching ) is closely	S4
raising capability and standards	S1
pairing on tasks	K04
peer review of team membersÂ’ code	S4
constructive feedback for improvement	S1
proactive contribution to continual improvements	S2
active participation in retrospectives	S2
engagement with cross team bestpractice	A1
support product owner	S1
identify and manage risks debt issues and opportunities	A1
support the recruitment activities	S4
technical support	S1
technical support	S1
implementation skills	K04
java	K02
SpringBoot	K02
unit testing	K01
development	K02
agile	K02
integration of testing into development workflow	S4
test frameworksÂ• build tooling	K04
maven)Â•	K04
work in ui	K01
continual delivery pipeline tools	S4
jenkins	K04
ansible	A1
communication skills	S1
articulate clearly to technical team members	S4
work with product owners	S1
collaborative	S1
critical reasoning	K04
problem solving	A1
agile software development	K02
xp	K02
BDD	K02
TDD	K02
fast turnaround development	K02
continuous delivery	S4
service orientated	S2
microservice architectureÂ•	K02
shared-nothing architecture	K02
domain driven design	K02
bounded contextÂ•	S1
high volume transactional systemsÂ•	K04
api gateway	K04
Akana	K04
coherent software architecture and designÂ•	K02
message or event based architecturesÂ•	S1
eventual consistency concepts	S1
contributor to open source projects	K02
mechanical understanding	K04
automation	K02
process optimization	K04
support and problem-solving	S1
decanters	S2
high-speed separators	K04
putting put the customer first	S2
preventive maintenance of supplied equipment and machines	S3
repair and service according to customer requirements	S2
support to customers	S1
general technical support	K04
adjustments to equipment and machines	S2
start-up and commissioning of machinery	S4
process plants on board vessels	K04
training of the crew	S4
optimization of plant and equipment	S4
decanters	S2
high-speed separators	K04
PureBilge	K02
FWG	S1
pure	K02
marine business	K02
sailing	K01
mechanical understanding	K04
automation	K02
control systems	K01
microsoft office	S1
danish	K01
english	L1
developing our new data backbone	K04
inspiring the stakeholders	A1
advanced analytics	K04
artificial intelligence	K02
extracting insights and value from data	S1
applying domain expertise	K02
ensure data collection procedures	S2
building analytic systems	K04
operationalise data mining and analysis into business applications	K02
maintain the productionised models	S2
quantitative or data-heavy functions	K02
c#	K02
python	S1
java	K02
open source data ingestion tools	S1
nifi	S2
cloud platforms	K02
container technology tools	K02
analytics engines	K04
spark	K02
Databricks	K02
data visualisation tools	K02
cloud platforms	K02
machine learning	K01
algorithms	K05
willingness to learn	S1
criminal record certificate	K01
criminal record certificate	K01
criminal record certificate	K01
registering and controlling goods	S6
picking and packing	K04
preparing pallets	S4
loading and unloading lorries	S4
operating a forklift	K04
forklift license	K04
independently	S1
proactively	A1
set high standards	K04
flexible	A1
helpful	A1
developing and applying new optical microscopy techniques	S2
intestine	S3
biopharmaceuticals	K02
reinvent our research strategies	K02
constructing a 'light sheet' fluorescence microscope	S2
live-sample imaging	K02
3d printed organoids	K04
pursue a deeper understanding	A1
implementing one of the worlds most advanced optical microscopes	S2
use the microscope	S2
capture how fluorescently labelled biopharmaceuticals travel through the intestinal barrier	S3
optimizing microscope hardware and software	S2
provide the best images	K02
drive hardware/software development	K02
document present and publish scientific findings	S2
contribute to the enjoyable and collaborative work environment	S1
master's degree	K01
work independently	S1
prioritize tasks	S4
plan and execute complex hardware implementation	A1
interface optics	S2
electronics	K02
software	K02
work constructively in a team	A1
analyse	K02
contribute	S1
solve biological/mathematical challenges	K04
use software for instrument control	K02
labview	K02
use software for data simulation	S1
basic image analysis	K02
matlab	K04
use software for basic mechanical design	K02
SOLIDWORKS	S1
communicate professionally	S1
english	L1
present insights progress and bottlenecks	A1
european code of conduct for research integrity	K04
software/hardware development	K02
fundamental biology/physiology	S3
bsc/msc diploma	K01
research	K01
teaching	K01
marketingÂ—in	K02
business	K02
development	K02
active engagement	A1
strengthen the relationship	S1
initiate and participate in external funding	S2
sustained record of research publications	K02
research management	K01
teaching	K01
provide dynamic leadership	S4
teaching	K01
research dissemination	K01
working with business and society	S1
undertaking research	K01
teaching practice	K01
dissemination	S1
business research	K02
research management	K01
initiation of research projects	S2
supervision of ph.d	K04
international research co-operation	K01
journal editorship	K04
reviewing for academic journals	S2
academic development	K01
marketing	K02
research-based teaching	K01
supervision	S1
examination	K01
teaching on business research	S1
course and program development	K01
promotion	S4
participation in and possibly initiation of externally funded research projects	S1
contribution to the administrative responsibilities	S1
dissemination of research findings	S2
participation in the departmentÂ’s regular research activities	S3
engagement in and contribution to academic citizenship activities	S1
participate actively in the research and teaching activities	K01
maintain and establish broad links	S1
record of research	K01
teaching	K01
research management	K01
research	K01
teaching	K01
business research	K02
provide dynamic leadership	S4
development of research	K01
teaching	K01
research dissemination	K01
working with business and society	S1
achieving ) research grants	S1
pedagogical qualifications	K01
development and innovation in the pedagogical area	K01
english	L1
teaching qualifications	K01
teaching evaluations	K01
love being outdoors	A1
create an entertaining & memorable tour	S4
share your knowledge?	S1
responsible and professional work ethic?	A1
providing fun informative and engaging tours	S1
know all information provided	S1
run tours on time	S4
provide extensive information about the city	S1
answering customer questions	S1
show independent thinking	A1
professonal approach	K04
leadership	K04
assiting with teambuilding excercises	A1
leading	A1
meticulous	K04
detail-oriented	A1
ensure the shop is tidy and clean	A1
dusting	K04
vacuuming	K04
set up for your customers	S1
independent work approach	S1
street-marketing	K02
street-marketing	K02
approaching people	S1
confident	A1
engaging	A1
english	L1
german	L1
danish	K01
lively	K04
fun	A1
public speaking	S1
engage an audience	S2
responsible	A1
dutiful	K02
mature	K02
demonstrate leadership abilities	K04
service-minded	S1
providing a first-class experience	S1
perform at your best ability	A1
high-school diploma	K01
bachelor/post-graduate degree	K01
danish	K01
english	L1
service-industry	S2
tourism	K02
social media marketing	S1
sales	K02
Segways	S1
first-aid skills	K04
stamina	A1
love for being outdoors	A1
supply chain	S1
manage challenges	S1
business acumen	A1
planning skills	K04
collaborating	S1
ensure reliable supply	A1
operating in a structured formal monthly sales and operations planning process	S4
sales and operations planning process	K04
maximize product availability	K02
standardized global processes	K01
sap	K02
optimize supply and inventory plans	S2
lead supply scenario analysis	A1
monitor supply and capacity performance	S2
coordinate supply and capacity bottleneck management	K04
support the supply risk management process	S1
respond to ad hoc requests	S2
establish and develop a close collaboration	S1
planning	K04
masterÂ’s degree	K01
business	K02
engineering	K04
supply chain management	K04
supply chain	S1
sap apo	K04
providing ideas and input for optimization	S1
handle hands-on planning tasks	S4
complex coordination	S1
overview	S1
sense of detail	K02
open-minded	S1
establish collaborative relations to people	S1
tailor your communication to your audience	S1
make people prioritize your agenda	S1
advanced electron microscopy	K04
environmental catalysis	K02
nanomaterials	K02
selective catalytic reduction ( scr ) of nox	K04
undertake atomic-scale studies	K01
situ transmission electron microscopy	S2
characterization tools	S1
surface science techniques	K02
catalyst testing	K01
synthesis	K02
develop an understanding of the catalytic performances	S2
target new designs of catalyst materials	K02
improving nox emission control	A1
experimental research	K01
scr catalysts	S2
application of s/tem and eels for atomic-resolution and in situ studies	S2
develop our atomic-scale model	K02
scr	K04
scr catalysis	S3
publishing in high-profile journals	S2
committed	A1
flexible	A1
innovative mind-set	A1
new ideas	S1
ready to face new challenges	S1
take responsibility	S1
execute and communicate complex research goals	S1
enthusiastic	A1
catalysis sciences	K02
Ph.D	K04
physics	K02
chemistry	K02
high-resolution ( scanning ) transmission electron microscopy ( s/tem	S2
heterogeneous catalysts	K04
solid-state nanomaterials	K02
audio engineering	K02
acoustic design	K02
algorithm trimming	K04
sound quality evaluation	K02
passion	S1
creativity	K02
work on new algorithm concepts	S1
directionality/beam-forming	K04
trimming and verification of various audio algorithms	S4
audio engineering	K02
msc	K06
outgoing	A1
getting things to move forward	A1
inspires your colleagues	S1
dealing with many stakeholders	S1
setting a direction	S4
english	L1
audio engineering	K02
algorithm concepting	K04
directionality	A1
beam-forming	K04
matlab	K04
python	S1
trimming of various audio algorithms	S4
noise reduction systems	K02
eq	S1
compressors	S2
objective and subjective sound quality evaluation	A1
measurement systems for audio evaluation	S2
soundcheck	K02
head acoustics acqua audio analyzers	K04
communicating technical issues	S1
research the market	K02
take initial contact to potential clients	S1
carry out market research of potential clients	S2
establish initial contact to potential clients	S1
translate sales material	S1
english	L1
italian	L1
italian	L1
english	L1
tele marketing	K02
proactive on the phone	S1
independent	S1
positive	A1
proactive	S2
danish	K01
working in a sales department	S4
leading technology strategy roadmaps and transformation plans	S1
communication	S1
integration	S1
PLM/PDM	K06
manufacturing execution	K02
product quality systems ( qsys	S1
global erp ( sap ) platforms	S1
dynamic	K02
personal motivation	A1
drive	K04
approach complex tasks	A1
open mind	K04
focus	S1
providing the best solution	S1
structured	K02
analytic	K04
lead the technology roadmap	K04
participate actively in strategic projects	S4
PLM	K01
main interface between plm data and systems governance organizations	S1
lead and coach a team	S4
PLM	K01
model and control enterprise plm architecture ( data and systems	K04
TOGAF	S1
asses value propositions of project proposals	S2
Teamcenter	A1
PLM	K01
how systems interact with erp	S1
manufacturing execution systems	K01
PLM	K01
erp systems	S2
capturing requirements from large organizations	S2
architecting value creating solutions for the business	S1
enabling the software to create value	S1
processes	K01
lifecycles	S3
wind turbine	K04
communicate on all levels	S1
persuasive communicator	S1
english	L1
teaching	K01
research	K01
basic and applied nutrition of ruminants	S3
dairy cattle	K02
dairy production	K02
data modelling	K02
evaluation of feed quality and feed intake in dairy cattle	S3
nordic feed evaluation system	S1
NorFor	A1
dairymanagement system	S3
feed evaluation	S2
digestive processes	S3
intermediary metabolism	S3
impact of nutrition and feeding management	S3
animal health	S3
product quality	S1
research	K01
publication/academic dissemination	K01
research-based teaching	K01
examination	K01
sharing knowledge with society	S1
phd degree	K01
research	K01
teaching	K01
enterprising	A1
interpersonal skills	S1
information technology	K02
java	K02
algorithm	K05
database	K02
multithreading	K04
concurrency	S1
solve technical challenges	S1
deliver high quality code	S1
build and ship new features	K04
write high quality testable and efficient code	S1
promote new ideas	S1
take active part in features discussions and roadmap prioritisation	S4
integrate cutting edge research and technologies	S1
work closely with our customers and other teams	S4
developing production level software	K02
designing multi-threaded systems and algorithms	S4
system design	K02
data structures	K02
algorithms	K05
java	K02
troubleshooting	K04
performance profiling	K04
optimisation	S2
development methodologies	K02
care about code quality	S1
communication skills	S1
sense of humor!	A1
eCommerce	K02
price comparison	K02
online portal	K04
.net	S1
agile	K02
rest	A1
microservices	K02
eCommerce	K02
price comparison	K02
online portal	K04
.net	S1
agile	K02
rest	A1
microservices	K02
development test and deployment of new components	K04
transition	S1
re-engineering	K04
design	K02
extension	K02
continuous integration	S1
continuous deployment	S4
.net	S1
micro services	K02
development and implementation of rest api's	S4
web and/or e-commerce	S1
agile method practice	K04
english	L1
german	L1
data science	K01
it security	K04
software development / engineering	K01
java	K02
rest	A1
cloud	K02
spring	K02
design-patterns	K02
data science	K01
it security	K04
software development / engineering	K01
java	K02
rest	A1
cloud	K02
spring	K02
design-patterns	K02
enthusiasm	A1
professional attitude	A1
work together closely with product owners and colleagues	S1
develop an in-depth understanding of the domains and the requirements	S2
happy to share your valuable insights	S1
offer them professional advice	S1
share your knowledge	S1
advise individual colleagues	S1
software development	K02
agile project team	S4
java stack frameworks	S1
quality	K02
testing at various levels in an agile environment	S2
test automation	S1
clear easy-to-maintain code	S1
latest technologies	K02
back end development	K04
databases	K03
cloud computing	K02
restful api	K04
big data	K02
devops	S2
build implement and operate a system	S2
architecture concepts	K02
design patterns	K02
german	L1
english	L1
digital agency	S1
software development / engineering	K01
user experience	S1
javascript	S1
angular	K02
reactjs	A1
vue.js	K02
typescript	K02
digital agency	S1
software development / engineering	K01
user experience	S1
javascript	S1
angular	K02
reactjs	A1
vue.js	K02
typescript	K02
develop attractive state-of-the-art user interfaces	S1
application architecture	K02
api design	K02
implementation of functionality	A1
code reviews	K02
technical advice for our customers	S1
guidance and support for your teammates	S4
realize exciting projects	K02
degree in computer science	K01
javascript/typescript	K02
angular	K02
react	A1
vue	K02
architecture of complex single page applications	K04
accessibility	S1
usability	A1
current web standards	K02
code quality	K02
clean code	K02
quality and responsibility	A1
eye for aesthetics design	K02
faithful implementation	A1
german	L1
english	L1
financial services	K02
financial technology	K02
regulatory reporting	K01
c#	K02
typescript	K02
.net-core	K02
less	A1
sql-server	S1
financial services	K02
financial technology	K02
regulatory reporting	K01
c#	K02
typescript	K02
.net-core	K02
less	A1
sql-server	S1
deliver software solutions	K02
creation of programs	K01
configuration/customisation of platforms	K02
capture & analysis of requirements	S2
requirements capture/analysis and documentation	S1
design ( and documenting ) of own solutions	S1
writing software	S1
configuring software platforms	S2
troubleshooting	K04
debugging code	K04
testing	K01
analysis of test results	K01
documentation	S1
microsoft	K02
web development	K02
c#	K02
.net core	S1
.net framework	S1
sql	S1
sql server	S1
typescript	K02
javascript	S1
asp.net	K04
Blazor	A1
javascript	S1
JQuery	K02
angular	K02
react	A1
vue	K02
html5	S1
css ( less	S1
Bootstrap	K04
troubleshooting it infrastructure related issues	S2
microsoft-based development environment	K02
microsoft certifications	K01
team player	A1
methodical and reliable approach	K04
problem solving	A1
financial services	K02
communication skills	S1
java	K02
testing	K01
web-services	S1
java	K02
testing	K01
web-services	S1
solving business problems	A1
innovation & engineering practices	S1
apply your depth of knowledge and expertise	K04
software development lifecycle	K02
partner continuously with your many stakeholders	S1
stay focused on common goals	S1
creating api services	S1
work closely with colleagues and the business	S1
functional and non-functional requirements	S2
drive the design and implementation of well tested easily supportable scalable and robust solutions	S1
bs/ba degree	K01
deployment approaches	S1
considerations	S2
managing deployments	S4
industry wide technology strategies	K01
best practices	S1
work in large collaborative teams	S1
achieve organizational goals	A1
building an innovative culture	K02
java ( version 8 or higher	K02
spring boot	K02
performance testing	K01
unit testing	K01
integration testing	K01
behavioural testing frameworks	S2
mocking frameworks	S1
continuous integration	S1
designing applications	K02
high throughput mission critical high performance stp platforms	A1
designing and building reusable services	K02
support the developers in your team	S4
leading	A1
supporting	K02
coaching	K01
application delivery	K01
stakeholder management	S4
oracle	S2
cloud services	K02
information technology	K02
technology consulting	K02
.net	S1
microsoft-dynamics	K04
dynamics-365	K04
cloud services	K02
information technology	K02
technology consulting	K02
.net	S1
microsoft-dynamics	K04
dynamics-365	K04
developing	K02
development	K02
customisation	K02
configuration	K02
development of plug-ins	K04
c#	K02
work with business product owners and business analysts	S1
elicit requirements	S2
assist in developing design specifications	K02
maximise the benefit	S2
collaborate with other stakeholders/ end users	S1
software development lifecycle	K02
design	K02
development	K02
delivery	K02
dynamics 365	K04
dynamics crm	K04
dynamics 365	K04
.net	S1
ms dynamics 365	K04
technical aptitude	S2
providing extraordinary customer service influence impact	S1
problem-solving	A1
building customer and partner relationships	S1
microsoft stack	S1
dynamics 365	K04
scrum/agile	K04
sc clearance eligible	A1
.net webapi	K02
sharepoint	K02
vehicle tracking	K04
azure	K02
.net	S1
c#	K02
azure-cosmosdb	K04
rest	A1
vehicle tracking	K04
azure	K02
.net	S1
c#	K02
azure-cosmosdb	K04
rest	A1
development cycle	K02
analyzing	K01
deciding the best approach	S1
write code	K02
design patterns	K02
unit tests	K01
design	K02
write code	K02
.net	S1
modify .net services and apis	S1
apis	S2
maintain strong backend code quality	K04
c#	K02
.net framework	S1
.net core	S1
t-sql ( ms sql server	S1
object-oriented design	K02
restful services	K04
azure storage	K02
azure eventhub	A1
azure functions	K02
azure data lake	K02
azure cosmosdb	K02
security principles	K01
computer science	K01
engineering	K04
teamwork	A1
attention to detail	K02
resourceful	K02
problem solving	A1
communication skills	S1
english	L1
qa	S1
automation	K02
testing	K01
qa	S1
automation	K02
testing	K01
delivering real quality	S1
planning test activities for each build cycle	S4
testing client configurations	S2
reporting the results	S2
incorporating that testing into automation	S4
reporting and documenting issues found	S1
following up on issues raised	S4
communicator	S1
connect together complex issues	S1
appreciate quality	S1
testing	K01
automation	K02
complex system	K02
code	K02
financial services	K02
qa	S1
python	S1
automation	K02
financial services	K02
qa	S1
python	S1
automation	K02
automation	K02
functional testing	K01
regression/reconciliation	S2
new feature testing	S1
continuous delivery	S4
end to end automated testing	S4
data integrity	A1
performance	K02
presentation quality	S1
software development	K02
automate end to end test requirements	S4
java/python	K02
schedule and execute regression cycles	S3
execution of non-functional regression testing	S3
ensure the resiliency and performance of the system	S2
operational processes	K01
provide solutions	S1
improve operational efficiency	A1
agile	K02
participating in sprint planning backlog refinement	S4
retrospectives	S2
defect management	S3
of test coverage	S2
identify gaps	S1
provide improvements	A1
it/quality assurance	K02
bachelor's degree	K01
computer science	K01
quality assurance	K02
testing arena	K01
quality assurance methods/processes	S2
lifecycle principles	K02
quality assurance processes	K04
automated testing	K01
java	K02
python	S1
testing of mainframe	S2
test automation frameworks	S1
communicate	S1
work under pressure	A1
resolve issues affecting the production services	S2
detail oriented	A1
work independently	S1
core java	K02
unix scripting	K04
sql	S1
continuous integration ( ci	S1
git	A1
jenkins	K04
mainframe/ibm iseries	K04
iseries menu/end of day	S2
read/publish on message	S1
financial services	K02
cloud	K02
java	K02
amazon-web-services	S1
financial services	K02
cloud	K02
java	K02
amazon-web-services	S1
solving business problems	A1
innovation and engineering practices	S1
apply your depth of knowledge and expertise	K04
software development lifecycle	K02
partner continuously with your many stakeholders	S1
stay focused on common goals	S1
bs/ba degree	K01
core java	K02
spring boot	K02
Microservices	K02
AWS	S1
Kubernetes	K02
Docker	K04
Spinnaker	K04
devops	S2
ci/cd automation	K04
application data and infrastructure architecture disciplines	K01
industry-wide technology trends and best practices	S1
work in large collaborative teams	S1
achieve organizational goals	A1
building an innovative culture	K02
business analysis	K02
development	K02
maintenance	K02
software improvement	K02
artificial intelligence	K02
machine learning	K01
translation	L1
node.js	S1
javascript	S1
nestjs	A1
artificial intelligence	K02
machine learning	K01
translation	L1
node.js	S1
javascript	S1
nestjs	A1
design and develop a micro-service architecture	K02
gather understand and prioritize requirements	S2
research potential solutions	K02
rapidly build prototypes	S2
distill and communicate what was learned expected risks necessary resources	S1
security concerns	S1
provide high-level technical design	K02
strategy roadmap development	K04
technical architecture	K02
assure that our architectures are consistent	S2
industry best practices	S1
scalability	K04
availability	A1
maintainability	A1
flexibility	A1
communicate strategies and processes	S1
select the best talent to join	A1
onboard new colleagues	S1
javascript	S1
typescript	K02
node.js	S1
NestJS	S1
writing highly tested software	S1
unit testing	K01
integration	S1
defining and modelling a consumable api	S2
work autonomously	A1
energized by missions and goals	S4
designing	K02
analyzing	K01
optimising code	K04
troubleshooting large-scale distributed systems	S2
python	S1
django	K04
docker	A1
orm	K04
sqlalchemy	K04
python	S1
django	K04
docker	A1
orm	K04
sqlalchemy	K04
lead the design & implementation	K02
back-end services	K04
drive the implementation of new forecasting algorithms and tooling	S4
responsibility for live productions systems	S2
perform developer tests	K01
peer code reviews	S1
prepare strong documentation	S1
develop tools	K02
improve and maintain components & systems	S1
python	S1
back-end programming	K04
database structures	K02
webapp design	K02
python	S1
orms	K04
Django	K04
ORM	S3
SQLAlchemy	K02
designing & implementing distributed system architectures and apis	S2
docker	A1
deploy your applications	S1
computer engineering	K01
manage individual priorities deadlines and deliverables	S4
contribute to engineering efforts	K04
solve complex engineering problems	K04
get-things-done attitude	A1
identify shortcomings quickly	A1
statistical modeling	K02
optimization problems	A1
work with many different stakeholders	S1
english	L1
eu/efta or swiss work permit	S1
information technology	K02
online travel	K04
java	K02
web-services	S1
python	S1
distributed-system	K02
amazon-web-services	S1
information technology	K02
online travel	K04
java	K02
web-services	S1
python	S1
distributed-system	K02
amazon-web-services	S1
java	K02
python	S1
Docker	K04
AWS	S1
hadoop/spark	K02
sql	S1
airflow	K02
Jupyter	K04
agile/lean	K04
base your decisions on solid data and metrics	S1
produce outstanding work	K02
break challenges into bite-size tasks	K04
mentor team mates	S4
demand quality	S1
machine learning	K01
cloud services	K02
apis	S2
developing a whole range of key product features	S2
defining and implementing services	S4
collaborate with product engineers	K02
accountable for your own projects	S1
trusted to deliver	A1
form part of a broader team	A1
takes collective responsibility	S1
making success happen	K02
mobile application	K02
android	K02
mobile	K02
kotlin	K02
architect	K02
build	K02
maintain	A1
tackle challenges	K02
find creative ways to implement new features	S1
Kotlin	K01
RxJava	K02
Couroutines	K04
share your knowledge	S1
keep up the high level of quality	K02
reviews	K02
pairing	K04
mentoring	K04
focus on a top-notch user experience	S1
make the app context aware	S1
google awareness api	S1
improve of our sync framework	S1
build features	K02
location based services	K02
design	K02
ui	S2
ux	S2
mobile technologies	K02
mobile wallets	S2
android sdk	K02
coding	K02
Kotlin	K01
solving technical challenges	K02
ios app	K02
backend development	K04
degree	K01
computer science	K01
android	K02
payment	S2
loyalty	A1
shopping	K02
eCommerce	K02
internet marketing	S1
java	K02
spring	K02
node.js	S1
reactjs	A1
high-quality well-tested and scalable code	K04
ensure code quality and maintainability	A1
evolving architecture and tech stack	S1
code reviews	K02
refactoring	S2
standards	S1
improving build and test systems	S2
coach guide and mentor teams	S4
architecture	K02
technology	K02
collaborate	S1
identifying managing and minimizing technical debt	A1
share architecture knowledge findings and standard methodologies	S1
java	K02
spring framework	S1
web technologies	K02
( non- ) relational databases	S1
node.js	S1
react	A1
design implementation and operation of distributed services and apis	S2
strategic thinker	A1
analytical	K02
critical thinking	K04
frame problems	K02
drive teams	S4
collect data	K01
guide the analysis	S1
present the data	K02
influence leadership	S4
agile software development	K02
product discovery	K02
continuous deployment	S4
aspiration for quality	S1
sense of pragmatism	K04
quality assurance	K02
quick adoption of new technologies	S2
speak at conferences	S1
engage in the community	S1
english	L1
communication	S1
