questioning	K04
expressing self clearly and	A1
seek develop and secure new opportunities	S4
measure monitor and review performance of key accounts	S4
ensuring budgets and forecasts are met	S4
identify and monitor key performance and financial indicators	S4
maintain and monitor service expectations of existing and key accounts	S4
support external sales force	S4
management of business	S4
select appropriate carrier	S4
maximise freight profits	S4
manage your own time	S4
integrate and co-ordinate new business	S4
arrange regular meetings	S4
submit financial reports	S4
CIMA	K01
care deeply	A1
ever-changing environment	S1
excel	K05
shape the world of iot	S4
advocate quality	S1
verify	S1
validate	S4
analyze	K02
lower risks	K09
automate tests	K07
build great products	S4
shape the features	S4
cloud-based microservices	S4
audio/video pipelines	S1
machine learning	K01
mobile applications	K09
critical thinker	K09
user experience	S1
quality	K02
software testing	K01
curiosity	K09
resourcefulness	A1
find problems	S1
provide creative solutions	S1
software testing techniques	K02
advocate for quality in decision making	S1
tinkerer	K04
create your own apps and robots	S4
working closely with developers	S1
diligent with documenting your test plans test cases bug reports	S4
coding	K02
python	S1
java	L1
javascript	S1
Golang	K02
selenium	K10
TestCafe	K09
web	K02
api	K09
backend	K09
integration	S4
performance/load/stress	S4
security testing	S4
continuous integration	S4
continuous delivery and/or deployment	S4
jenkins	K09
CircleCI	K09
linux	K02
Docker	K04
Kubernetes	K09
web services	K02
networking	K02
distributed systems	S4
cloud services	S4
GraphQL	L1
driving?	S4
fast-paced team environment?	S4
upholding a positive brand image	S4
providing excellent customer service	S1
managing cash and card transactions	S4
delivering products safely and securely	S4
avoiding unnecessary risks	S1
safety and security procedures	K09
uk or eu driving license	K02
own car	S4
local area	S4
fast-paced environment	A1
customer service	S4
quality	K02
driving!	S4
food hygiene	K09
store cleanliness	S4
keen eye for detail	S1
day to day running of kitchen ordering and installs	S4
work closely with our installation team	S1
deliver projects efficiently	S4
maintain an impeccable level of customer service	S1
joinery	K04
kitchen industry!	K05
email	K02
organisational skills	S1
self-motivated	A1
working on their own initiative	S4
communicator	K09
kitchen industry	K02
computers	K07
attention to detail	S1
building and maintaining strong relationships	S1
multi-task	S1
deliver against deadlines	S4
valid uk driving license	S4
communication skills	S1
kitchen industry	K02
valid uk driving licence	S4
a-level	S4
support the bakery management team	S4
support the teams	S4
go above and beyond for our customers	S4
positive	A1
energetic	A1
engaging with people	S1
communications skills	S1
talented	A1
fun	A1
ambitious	A1
provide first line support to our team of colleagues	S1
reporting directly to the head of team experience	S4
overseeing hr administration	S4
maintaining hr records	S4
compiling hr data	K04
running reports	S4
managing hr processes	S4
hr best practices	K09
processes	K02
policies	S4
employment law	K02
organisation	S4
attention to detail	S1
positive	A1
professional	A1
communication	S1
literacy	K05
numeracy	K04
it skills	K09
willingness to develop	S1
line management	S4
level 5 cipd	S4
Kronos	K03
maximising sales	S4
building a highly engaged and high performing team	S4
leading from the front	S4
hands-on approach	S4
inspire your team	S4
inject fun into the work place	S1
create a truly amazing place to work	S4
delivers an exceptional standard of customer service	S1
pet knowledge	S1
deliver the highest standards of pet care	S3
ensure that the welfare of pets is a top priority	S1
promoting responsible pet ownership	S1
motivating training and developing your team	S4
running a store	S4
achieving and exceeding key store targets	S4
communicate effectively to your team	S1
take full responsibility for the store	S4
involved in absolutely everything in your store	S4
recruitment	K02
stock control	S4
store standards	K02
retail	K02
pets!	K05
supervisory/management	S4
hands-on approach	S4
delivering high standards!	S4
people person	S4
team player	K09
communication	S1
engage and inspire a team	S4
proactive	A1
customer focused	A1
recording of events and service failures	S4
chasing and completion of calls	S4
production of work request failures	S4
liaising with internal team and external contractors	S4
maintenance of records of live and paid works	S4
kpi's	S4
SLA's	S1
raising purchase orders	S4
completion of worksheet upload spreadsheet	K04
cafm system administration	S4
assisting the helpdesk manager	S1
general office administration duties	S4
reporting	S4
provide minutes of meetings	S1
contract administration	S4
ensure the helpdesk operates professionally	S4
manage the lines of communication	S1
achieve a high degree of customer and supplier satisfaction	S1
achieving key performance indicators ( kpis	S4
customer service	S4
system knowledge	S4
operate a helpdesk function across multiple sites	S4
accurately record details of the caller problem and severity	S4
ensure that the service centre manager is aware of situations which could develop into issues	S4
work within and to processes and procedures	S4
respond quickly and efficiently to all requests	S1
attention to detail	S1
obtaining and inputting information	S1
clear and professional telephone manner	S4
achieve a high degree of customer and supplier satisfaction	S1
applying logic and common sense	S1
ensuring that identified criteria are escalated	S4
scheduling ppm remedial and reactive work	S4
jeopardy management	K04
escalation of planned and responsive works	S4
monitor and optimise the utilisation of engineer activities	S4
scheduling of works	S4
raising purchase orders	S4
run reports	S4
show outstanding work orders	S4
attend training and coaching sessions	S1
identify any potential areas of improvement	S4
flexible	A1
adaptable	A1
highlight any training needs and development	S4
operating a facilities management helpdesk	S4
call centre service	S4
developing productive working relationships	S1
qfm helpdesk system	S4
computer hardware	K07
peripherals	K09
applications	S4
networks	K09
shared files and folders	S1
report creation	S4
keyboard skills	S1
focusing on client & customer	S4
delivering stretched results	S4
act collaboratively	S1
intellectual agility	K09
willingness to learn	S1
computer databases	K07
nvq level 2 or 3	S4
customer service	S4
call handling	S4
working with and developing kpiâ€™s and measurement information	S4
rsa level i keyboard skills	S1
european computer driving licence ( ecdl ) level i	K02
microsoft word	L1
microsoft excel	K05
level 2 & 3 nursery	K01
providing care and educational support	S3
pms	K06
reservation systems	S4
customer service?	S1
organised analytical approach	K09
numerical skills	S1
pms	K06
reservation systems	S4
timekeeping	S4
work calmly in a high-pressure environment	S4
english	L1
making reservations	S4
ensuring that all enquiries receive a prompt response	S1
all correspondence is accurately filed	S1
log failures	K09
convert a booking	S4
monitor non-arrivals and late cancellations	S4
run daily arrival checks	S4
ensure all reservations are correct	S4
work with others	S1
improve our customer service	S2
cover reception	S4
monitoring and recording key data	S4
keeping the pms up-to-date	S4
ensure that market segmentation rates and guest information are accurately recorded	S4
helping the hotel to achieve its financial targets	S4
upsell	K04
escalate/communicate about any new sales leads	S4
contribute to pricing decisions	S1
highlighting if availability is changing	S4
rate strategies should be reviewed	S4
pms	K06
reservation systems	S4
organised	S4
analytical	K09
customer service	S4
commercial awareness	S4
corporate tax	K09
personal tax	S4
vat	K05
ACCA/ACA/ATT	S1
cta	K06
supporting and training the more junior member of staff	S4
manging	K04
supervising	K04
coaching	K01
mentoring	K04
work with a varied portfolio	S4
provide compliance and advisory services	S4
support clients	S1
services in corporation tax and personal tax	S4
work in a varied capacity	S4
confident	A1
professional	A1
ambitious	A1
tax planning	K02
advisory work	S4
tax computations and reviews	K04
capital gains tax	S4
trusts	S4
inheritance tax/wills	S4
property tax	K02
corporate tax planning	K02
mergers & acquisitions	S4
restructuring	K04
investments	S4
dealing with a variety of high net worth individuals partnerships directors tax omb	S1
manage the team	S4
planning and reviewing work in progress	S4
supporting the directors	S4
providing direction to the team	S4
lead and grow the department	S4
business development	S4
selling services	S4
CIMA	K01
help residents enjoy each day	S4
assist with daily living	S1
providing support and companionship	S1
dedication	K02
compassion	S1
supporting residents with their food and drink	S3
following care plans	S4
caring for older people	S1
can-do approach	S1
communication skills	S1
empathy	S1
warm-hearted approach	S4
compassion	S1
deliver the highest standard of care and support	S4
drive expansion	S4
exceed monthly / quarterly sales targets	S4
driving new opportunities	S1
exceed monthly / quarterly sales targets	S4
driving new opportunities	S1
analyse your industry territory	S4
identify prioritise and segment accounts	S4
collaborating	S1
create demand	S4
cold calling	S4
email / social campaigns	S4
supporting other business development activities	S1
engage your extended team	S4
engage with prospect organisations	S1
strategic value-based selling	S4
business case definition	K09
return on investment analysis	S4
references	S1
analyst data	K06
engage with customer cios and cfos	S1
converse with senior technologists	S1
generate short term results	S1
maintaining a long term perspective	S4
maximize overall revenue generation	S4
provide accurate monthly forecasting and revenue delivery	S4
build and maintain a territory pipeline of business	S4
selling enterprise software	S4
PaaS	S4
IaaS	K06
saas	K04
net direct new business sales	S4
consistent delivery against targets	S4
strong customer care	S1
helping to ensure customer success	S1
credibility	S1
building strong relationships internally and with the customer	S1
selling industry-specific use cases / technologies	S4
CPG	K06
manufacturing	K02
services	S4
iPaaS	K09
api management	S4
automation	K02
bpm	K06
deliver key business outcomes	S4
bachelorâ€™s degree	K01
full driving license	K09
internal framing work	S4
finishing work	S4
skirtings	S4
facings	K04
cscs card	K05
carpentry	K02
CSCS	K06
electro/mechanical assembly	K05
hand assembly	K09
wiring electronic sub-assemblies	K09
mechanical assembly	K02
working to customer specifications	S1
can do attitude	A1
driving	S4
strategic planning & governance	S4
strategic planning	S4
performance reporting	S4
strategic planning	S4
corporate performance	S4
manage the strategic planning and corporate performance reporting functions	S4
manage the strategic and operational planning process	S4
support senior colleagues	S1
completing plans	S4
provide specialist advice	S1
guidance	S4
support to managers staff and the public	S4
strategic planning	S4
corporate performance	S4
conduct stakeholder consultation/engagement	S4
engage with internal and external groups and networks	S4
development or expansion of good practice	S4
strategic planning	S4
corporate performance	S4
coordinate the preparation of an annual report	S4
ensure the annual report complies with the government financial reporting manual ( frem	S4
government financial reporting manual ( frem	S4
analytical decision making	K09
communication skills	S1
maintain positive relationships	S1
seek information and co-operation	S1
conduct trend analysis on complex data sets	S4
working with stakeholders	S1
inform of any discrepancies variances and trends	S4
scqf level 9	S4
technology	K02
project manage	S4
bridge the gap	S1
liaising with many stake holders	S1
influencing and negotiation skills	S4
prince2 practitioner qualification	K04
msp qualification	K04
project management	S4
change management	S4
benefit realisation	S4
workforce redesign	S4
energetic	A1
work independently as well as in a team	S1
persistent	A1
sales	S4
B2B	K06
concept sales	S4
business	K02
english	L1
french	L1
german	L1
java	L1
working in the web layer	S4
working as a key member of an agile team	S4
frequent delivery	S4
end-to-end application ownership	S4
contributing to a cross functional agile team	S1
elaboration development and testing of user storiesÂ•	S4
sprint planning	K02
backlog grooming	S1
task estimationÂ•	S4
development and modification of frameworks common components and business componentsÂ•	S4
development of unit tests	S4
contribution to the creation of automation in higher levels of the test pyramidÂ•	S4
refactoring code	K04
contribution to code quality improvementsÂ•	S1
development standards	S4
best practices	K01
software development	S4
review of colleagueÂ’s codeÂ•	S4
progressive development behaviours	S4
maximizing collaboration	S1
knowledge sharing	S1
effective pairing	S4
creation of pocÂ’s / spike development	S4
involvement in technology evaluation	S4
work and communicate across geographical and cultural borders	S1
build a strong professional network	S1
participation in the elaboration of user stories	S1
agree stories are sufficiently described	S1
quality design and implementation	S4
ensuring builds are kept green	S4
code management strategy ( branching ) is closely	S1
raising capability and standards	S4
pairing on tasks	S4
peer review of team membersÂ’ code	S4
constructive feedback for improvement	S4
proactive contribution to continual improvements	S1
active participation in retrospectives	S4
engagement with cross team bestpractice	S1
support product owner	S4
identify and manage risks debt issues and opportunities	S4
support the recruitment activities	S4
technical support	S4
technical support	S4
implementation skills	S1
java	L1
SpringBoot	S4
unit testing	K09
development	K02
agile	A1
integration of testing into development workflow	S4
test frameworksÂ• build tooling	K02
maven)Â•	K06
work in ui	S4
continual delivery pipeline tools	K04
jenkins	K09
ansible	A1
communication skills	S1
articulate clearly to technical team members	S1
work with product owners	S1
collaborative	S1
critical reasoning	K09
problem solving	S4
agile software development	S4
xp	K06
BDD	K06
TDD	K06
fast turnaround development	S4
continuous delivery	S4
service orientated	A1
microservice architectureÂ•	K02
shared-nothing architecture	S4
domain driven design	S4
bounded contextÂ•	A1
high volume transactional systemsÂ•	S4
api gateway	K04
Akana	K04
coherent software architecture and designÂ•	K03
message or event based architecturesÂ•	S4
eventual consistency concepts	S4
contributor to open source projects	S1
mechanical understanding	K02
automation	K02
process optimization	S4
support and problem-solving	S4
decanters	S4
high-speed separators	S4
putting put the customer first	S4
preventive maintenance of supplied equipment and machines	S4
repair and service according to customer requirements	S4
support to customers	S1
general technical support	S4
adjustments to equipment and machines	S4
start-up and commissioning of machinery	S4
process plants on board vessels	K05
training of the crew	S4
optimization of plant and equipment	S4
decanters	S4
high-speed separators	S4
PureBilge	S4
FWG	K09
pure	A1
marine business	K02
sailing	K04
mechanical understanding	K02
automation	K02
control systems	S4
microsoft office	K02
danish	K02
english	L1
developing our new data backbone	S4
inspiring the stakeholders	S1
advanced analytics	S4
artificial intelligence	K09
extracting insights and value from data	S1
applying domain expertise	S1
ensure data collection procedures	S4
building analytic systems	S4
operationalise data mining and analysis into business applications	S4
maintain the productionised models	S4
quantitative or data-heavy functions	S4
c#	K06
python	S1
java	L1
open source data ingestion tools	S4
nifi	K09
cloud platforms	K02
container technology tools	K02
analytics engines	K01
spark	S1
Databricks	K03
data visualisation tools	K02
cloud platforms	K02
machine learning	K01
algorithms	K03
willingness to learn	S1
criminal record certificate	K09
criminal record certificate	K09
criminal record certificate	K09
registering and controlling goods	S4
picking and packing	S4
preparing pallets	S1
loading and unloading lorries	S4
operating a forklift	S4
forklift license	K02
independently	S1
proactively	A1
set high standards	S4
flexible	A1
helpful	S1
developing and applying new optical microscopy techniques	S4
intestine	K09
biopharmaceuticals	K09
reinvent our research strategies	S4
constructing a 'light sheet' fluorescence microscope	S4
live-sample imaging	K04
3d printed organoids	S4
pursue a deeper understanding	S1
implementing one of the worlds most advanced optical microscopes	S4
use the microscope	S1
capture how fluorescently labelled biopharmaceuticals travel through the intestinal barrier	S4
optimizing microscope hardware and software	S4
provide the best images	S4
drive hardware/software development	S4
document present and publish scientific findings	S1
contribute to the enjoyable and collaborative work environment	S1
master's degree	K06
work independently	S1
prioritize tasks	S4
plan and execute complex hardware implementation	S4
interface optics	K06
electronics	K05
software	K02
work constructively in a team	S4
analyse	K02
contribute	S1
solve biological/mathematical challenges	S1
use software for instrument control	S4
labview	K02
use software for data simulation	S1
basic image analysis	K09
matlab	K06
use software for basic mechanical design	S4
SOLIDWORKS	K01
communicate professionally	S1
english	L1
present insights progress and bottlenecks	S4
european code of conduct for research integrity	S4
software/hardware development	K05
fundamental biology/physiology	K05
bsc/msc diploma	K01
research	K02
teaching	K01
marketingÂ—in	K04
business	K02
development	K02
active engagement	S4
strengthen the relationship	S1
initiate and participate in external funding	S4
sustained record of research publications	S4
research management	K02
teaching	K01
provide dynamic leadership	S1
teaching	K01
research dissemination	S4
working with business and society	S1
undertaking research	S4
teaching practice	K01
dissemination	S4
business research	K02
research management	K02
initiation of research projects	S4
supervision of ph.d	K04
international research co-operation	S1
journal editorship	K09
reviewing for academic journals	S1
academic development	K01
marketing	K02
research-based teaching	K01
supervision	S4
examination	K01
teaching on business research	K01
course and program development	S4
promotion	S4
participation in and possibly initiation of externally funded research projects	S1
contribution to the administrative responsibilities	S1
dissemination of research findings	S1
participation in the departmentÂ’s regular research activities	S4
engagement in and contribution to academic citizenship activities	S1
participate actively in the research and teaching activities	S1
maintain and establish broad links	S1
record of research	S2
teaching	K01
research management	K02
research	K02
teaching	K01
business research	K02
provide dynamic leadership	S1
development of research	S4
teaching	K01
research dissemination	S4
working with business and society	S1
achieving ) research grants	S1
pedagogical qualifications	K01
development and innovation in the pedagogical area	S1
english	L1
teaching qualifications	K01
teaching evaluations	K01
love being outdoors	S1
create an entertaining & memorable tour	S4
share your knowledge?	S1
responsible and professional work ethic?	S4
providing fun informative and engaging tours	S4
know all information provided	S1
run tours on time	S4
provide extensive information about the city	S4
answering customer questions	S1
show independent thinking	S1
professonal approach	K09
leadership	S4
assiting with teambuilding excercises	S4
leading	S4
meticulous	S2
detail-oriented	A1
ensure the shop is tidy and clean	S4
dusting	K04
vacuuming	K04
set up for your customers	S4
independent work approach	S4
street-marketing	S7
street-marketing	S7
approaching people	S4
confident	A1
engaging	S1
english	L1
german	L1
danish	K02
lively	A1
fun	A1
public speaking	S4
engage an audience	S1
responsible	A1
dutiful	A1
mature	A1
demonstrate leadership abilities	S1
service-minded	A1
providing a first-class experience	S1
perform at your best ability	S4
high-school diploma	K01
bachelor/post-graduate degree	S1
danish	K02
english	L1
service-industry	K10
tourism	K02
social media marketing	K02
sales	S4
Segways	K09
first-aid skills	S1
stamina	K09
love for being outdoors	S1
supply chain	K02
manage challenges	S4
business acumen	S4
planning skills	S1
collaborating	S1
ensure reliable supply	S1
operating in a structured formal monthly sales and operations planning process	S4
sales and operations planning process	S4
maximize product availability	S4
standardized global processes	S4
sap	K05
optimize supply and inventory plans	S4
lead supply scenario analysis	S4
monitor supply and capacity performance	S4
coordinate supply and capacity bottleneck management	S4
support the supply risk management process	S4
respond to ad hoc requests	S4
establish and develop a close collaboration	S1
planning	S4
masterÂ’s degree	K06
business	K02
engineering	K02
supply chain management	S4
supply chain	K02
sap apo	K06
providing ideas and input for optimization	S1
handle hands-on planning tasks	S4
complex coordination	S4
overview	K02
sense of detail	S4
open-minded	S1
establish collaborative relations to people	S1
tailor your communication to your audience	S1
make people prioritize your agenda	S4
advanced electron microscopy	K04
environmental catalysis	S4
nanomaterials	K01
selective catalytic reduction ( scr ) of nox	S4
undertake atomic-scale studies	S4
situ transmission electron microscopy	K04
characterization tools	S1
surface science techniques	K02
catalyst testing	K02
synthesis	K02
develop an understanding of the catalytic performances	S1
target new designs of catalyst materials	S4
improving nox emission control	S4
experimental research	K02
scr catalysts	K09
application of s/tem and eels for atomic-resolution and in situ studies	S4
develop our atomic-scale model	S4
scr	K02
scr catalysis	K09
publishing in high-profile journals	S4
committed	A1
flexible	A1
innovative mind-set	S2
new ideas	S1
ready to face new challenges	S1
take responsibility	S1
execute and communicate complex research goals	S4
enthusiastic	A1
catalysis sciences	K01
Ph.D	K06
physics	K05
chemistry	K05
high-resolution ( scanning ) transmission electron microscopy ( s/tem	S4
heterogeneous catalysts	S4
solid-state nanomaterials	S1
audio engineering	K02
acoustic design	K02
algorithm trimming	K04
sound quality evaluation	S4
passion	S4
creativity	K02
work on new algorithm concepts	S1
directionality/beam-forming	K05
trimming and verification of various audio algorithms	S4
audio engineering	K02
msc	K06
outgoing	A1
getting things to move forward	S4
inspires your colleagues	S1
dealing with many stakeholders	S1
setting a direction	S4
english	L1
audio engineering	K02
algorithm concepting	K04
directionality	K02
beam-forming	S1
matlab	K06
python	S1
trimming of various audio algorithms	S4
noise reduction systems	S4
eq	K06
compressors	S7
objective and subjective sound quality evaluation	S4
measurement systems for audio evaluation	S4
soundcheck	K02
head acoustics acqua audio analyzers	K09
communicating technical issues	S1
research the market	S1
take initial contact to potential clients	S1
carry out market research of potential clients	S4
establish initial contact to potential clients	S2
translate sales material	K02
english	L1
italian	L1
italian	L1
english	L1
tele marketing	K02
proactive on the phone	S4
independent	A1
positive	A1
proactive	A1
danish	K02
working in a sales department	S4
leading technology strategy roadmaps and transformation plans	S4
communication	S1
integration	S4
PLM/PDM	K06
manufacturing execution	K02
product quality systems ( qsys	K05
global erp ( sap ) platforms	S1
dynamic	A1
personal motivation	S1
drive	S4
approach complex tasks	S4
open mind	S4
focus	S4
providing the best solution	S1
structured	A1
analytic	K09
lead the technology roadmap	S4
participate actively in strategic projects	S1
PLM	K06
main interface between plm data and systems governance organizations	S4
lead and coach a team	S4
PLM	K06
model and control enterprise plm architecture ( data and systems	S4
TOGAF	K01
asses value propositions of project proposals	S4
Teamcenter	S4
PLM	K06
how systems interact with erp	S1
manufacturing execution systems	K02
PLM	K06
erp systems	K06
capturing requirements from large organizations	S4
architecting value creating solutions for the business	S4
enabling the software to create value	S1
processes	K02
lifecycles	K09
wind turbine	K01
communicate on all levels	S1
persuasive communicator	S1
english	L1
teaching	K01
research	K02
basic and applied nutrition of ruminants	S4
dairy cattle	K02
dairy production	K02
data modelling	K02
evaluation of feed quality and feed intake in dairy cattle	S4
nordic feed evaluation system	K01
NorFor	K06
dairymanagement system	K02
feed evaluation	K09
digestive processes	K09
intermediary metabolism	K09
impact of nutrition and feeding management	S4
animal health	K09
product quality	S4
research	K02
publication/academic dissemination	K01
research-based teaching	K01
examination	K01
sharing knowledge with society	S1
phd degree	K01
research	K02
teaching	K01
enterprising	A1
interpersonal skills	S1
information technology	K02
java	L1
algorithm	K02
database	K02
multithreading	K09
concurrency	K09
solve technical challenges	S1
deliver high quality code	S4
build and ship new features	S4
write high quality testable and efficient code	S4
promote new ideas	S1
take active part in features discussions and roadmap prioritisation	S4
integrate cutting edge research and technologies	S4
work closely with our customers and other teams	S1
developing production level software	S4
designing multi-threaded systems and algorithms	S4
system design	S4
data structures	K09
algorithms	K03
java	L1
troubleshooting	K01
performance profiling	K04
optimisation	K04
development methodologies	S4
care about code quality	S4
communication skills	S1
sense of humor!	A1
eCommerce	K02
price comparison	K02
online portal	S4
.net	S1
agile	A1
rest	S4
microservices	K09
eCommerce	K02
price comparison	K02
online portal	S4
.net	S1
agile	A1
rest	S4
microservices	K09
development test and deployment of new components	S4
transition	S1
re-engineering	S4
design	K02
extension	K02
continuous integration	S4
continuous deployment	S4
.net	S1
micro services	K02
development and implementation of rest api's	S4
web and/or e-commerce	S4
agile method practice	S4
english	L1
german	L1
data science	K02
it security	K09
software development / engineering	S4
java	L1
rest	S4
cloud	K02
spring	S4
design-patterns	K02
data science	K02
it security	K09
software development / engineering	S4
java	L1
rest	S4
cloud	K02
spring	S4
design-patterns	K02
enthusiasm	A1
professional attitude	S1
work together closely with product owners and colleagues	S1
develop an in-depth understanding of the domains and the requirements	S4
happy to share your valuable insights	S1
offer them professional advice	S1
share your knowledge	S1
advise individual colleagues	S1
software development	S4
agile project team	S4
java stack frameworks	K03
quality	K02
testing at various levels in an agile environment	S4
test automation	K05
clear easy-to-maintain code	S4
latest technologies	K02
back end development	K09
databases	K07
cloud computing	K02
restful api	A1
big data	K04
devops	K04
build implement and operate a system	S4
architecture concepts	K02
design patterns	K02
german	L1
english	L1
digital agency	K02
software development / engineering	S4
user experience	S1
javascript	S1
angular	A1
reactjs	K06
vue.js	S1
typescript	K02
digital agency	K02
software development / engineering	S4
user experience	S1
javascript	S1
angular	A1
reactjs	K06
vue.js	S1
typescript	K02
develop attractive state-of-the-art user interfaces	S4
application architecture	S4
api design	K02
implementation of functionality	S4
code reviews	K02
technical advice for our customers	S1
guidance and support for your teammates	S1
realize exciting projects	S4
degree in computer science	K01
javascript/typescript	S1
angular	A1
react	S1
vue	K02
architecture of complex single page applications	S4
accessibility	K09
usability	K09
current web standards	K09
code quality	K02
clean code	S4
quality and responsibility	S4
eye for aesthetics design	S4
faithful implementation	S4
german	L1
english	L1
financial services	K01
financial technology	K02
regulatory reporting	S4
c#	K06
typescript	K02
.net-core	K05
less	A1
sql-server	S1
financial services	K01
financial technology	K02
regulatory reporting	S4
c#	K06
typescript	K02
.net-core	K05
less	A1
sql-server	S1
deliver software solutions	S1
creation of programs	S4
configuration/customisation of platforms	S4
capture & analysis of requirements	S4
requirements capture/analysis and documentation	S4
design ( and documenting ) of own solutions	S4
writing software	K02
configuring software platforms	S4
troubleshooting	K01
debugging code	S4
testing	K01
analysis of test results	S4
documentation	K02
microsoft	K05
web development	K09
c#	K06
.net core	S1
.net framework	S1
sql	S1
sql server	S1
typescript	K02
javascript	S1
asp.net	S1
Blazor	K09
javascript	S1
JQuery	K06
angular	A1
react	S1
vue	K02
html5	S1
css ( less	S1
Bootstrap	K01
troubleshooting it infrastructure related issues	S4
microsoft-based development environment	S4
microsoft certifications	K01
team player	K09
methodical and reliable approach	S4
problem solving	S4
financial services	K01
communication skills	S1
java	L1
testing	K01
web-services	K05
java	L1
testing	K01
web-services	K05
solving business problems	S1
innovation & engineering practices	S4
apply your depth of knowledge and expertise	S1
software development lifecycle	K01
partner continuously with your many stakeholders	S1
stay focused on common goals	S1
creating api services	S4
work closely with colleagues and the business	S1
functional and non-functional requirements	S4
drive the design and implementation of well tested easily supportable scalable and robust solutions	S4
bs/ba degree	K06
deployment approaches	S4
considerations	S4
managing deployments	S4
industry wide technology strategies	S4
best practices	K01
work in large collaborative teams	S1
achieve organizational goals	S4
building an innovative culture	S4
java ( version 8 or higher	S4
spring boot	K02
performance testing	S4
unit testing	K09
integration testing	S4
behavioural testing frameworks	K09
mocking frameworks	K04
continuous integration	S4
designing applications	K02
high throughput mission critical high performance stp platforms	S4
designing and building reusable services	S4
support the developers in your team	S4
leading	S4
supporting	S1
coaching	K01
application delivery	S4
stakeholder management	S4
oracle	K05
cloud services	S4
information technology	K02
technology consulting	K02
.net	S1
microsoft-dynamics	K05
dynamics-365	K02
cloud services	S4
information technology	K02
technology consulting	K02
.net	S1
microsoft-dynamics	K05
dynamics-365	K02
developing	S4
development	K02
customisation	K04
configuration	K02
development of plug-ins	S4
c#	K06
work with business product owners and business analysts	S1
elicit requirements	K09
assist in developing design specifications	S4
maximise the benefit	S1
collaborate with other stakeholders/ end users	S1
software development lifecycle	K01
design	K02
development	K02
delivery	S4
dynamics 365	K02
dynamics crm	K06
dynamics 365	K02
.net	S1
ms dynamics 365	K02
technical aptitude	S1
providing extraordinary customer service influence impact	S1
problem-solving	S1
building customer and partner relationships	S1
microsoft stack	K02
dynamics 365	K02
scrum/agile	S4
sc clearance eligible	A1
.net webapi	S1
sharepoint	S4
vehicle tracking	K01
azure	K06
.net	S1
c#	K06
azure-cosmosdb	K06
rest	S4
vehicle tracking	K01
azure	K06
.net	S1
c#	K06
azure-cosmosdb	K06
rest	S4
development cycle	K02
analyzing	K02
deciding the best approach	S4
write code	S4
design patterns	K02
unit tests	S4
design	K02
write code	S4
.net	S1
modify .net services and apis	S1
apis	K04
maintain strong backend code quality	S4
c#	K06
.net framework	S1
.net core	S1
t-sql ( ms sql server	S1
object-oriented design	S4
restful services	S4
azure storage	K04
azure eventhub	K06
azure functions	K06
azure data lake	S4
azure cosmosdb	K06
security principles	K02
computer science	K05
engineering	K02
teamwork	S4
attention to detail	S1
resourceful	A1
problem solving	S4
communication skills	S1
english	L1
qa	K09
automation	K02
testing	K01
qa	K09
automation	K02
testing	K01
delivering real quality	S4
planning test activities for each build cycle	S4
testing client configurations	S4
reporting the results	S1
incorporating that testing into automation	S4
reporting and documenting issues found	S4
following up on issues raised	S4
communicator	K09
connect together complex issues	S1
appreciate quality	S1
testing	K01
automation	K02
complex system	S4
code	K02
financial services	K01
qa	K09
python	S1
automation	K02
financial services	K01
qa	K09
python	S1
automation	K02
automation	K02
functional testing	S4
regression/reconciliation	S4
new feature testing	S4
continuous delivery	S4
end to end automated testing	S4
data integrity	S4
performance	S4
presentation quality	S4
software development	S4
automate end to end test requirements	S4
java/python	K05
schedule and execute regression cycles	S4
execution of non-functional regression testing	S4
ensure the resiliency and performance of the system	S4
operational processes	S4
provide solutions	S1
improve operational efficiency	S4
agile	A1
participating in sprint planning backlog refinement	S4
retrospectives	S4
defect management	S4
of test coverage	S4
identify gaps	S4
provide improvements	S1
it/quality assurance	S4
bachelor's degree	K01
computer science	K05
quality assurance	S4
testing arena	K02
quality assurance methods/processes	S4
lifecycle principles	K02
quality assurance processes	S4
automated testing	S4
java	L1
python	S1
testing of mainframe	K04
test automation frameworks	K01
communicate	S1
work under pressure	S4
resolve issues affecting the production services	S4
detail oriented	S1
work independently	S1
core java	K09
unix scripting	K04
sql	S1
continuous integration ( ci	S4
git	K09
jenkins	K09
mainframe/ibm iseries	K04
iseries menu/end of day	K04
read/publish on message	S4
financial services	K01
cloud	K02
java	L1
amazon-web-services	K03
financial services	K01
cloud	K02
java	L1
amazon-web-services	K03
solving business problems	S1
innovation and engineering practices	S4
apply your depth of knowledge and expertise	S1
software development lifecycle	K01
partner continuously with your many stakeholders	S1
stay focused on common goals	S1
bs/ba degree	K06
core java	K09
spring boot	K02
Microservices	K09
AWS	S1
Kubernetes	K09
Docker	K04
Spinnaker	K02
devops	K04
ci/cd automation	K05
application data and infrastructure architecture disciplines	K04
industry-wide technology trends and best practices	S4
work in large collaborative teams	S1
achieve organizational goals	S4
building an innovative culture	S4
business analysis	K02
development	K02
maintenance	S4
software improvement	K02
artificial intelligence	K09
machine learning	K01
translation	L1
node.js	S1
javascript	S1
nestjs	K09
artificial intelligence	K09
machine learning	K01
translation	L1
node.js	S1
javascript	S1
nestjs	K09
design and develop a micro-service architecture	S4
gather understand and prioritize requirements	S4
research potential solutions	K02
rapidly build prototypes	S4
distill and communicate what was learned expected risks necessary resources	S4
security concerns	S4
provide high-level technical design	S1
strategy roadmap development	S4
technical architecture	K02
assure that our architectures are consistent	S4
industry best practices	K01
scalability	K09
availability	S4
maintainability	S4
flexibility	A1
communicate strategies and processes	S1
select the best talent to join	S4
onboard new colleagues	S1
javascript	S1
typescript	K02
node.js	S1
NestJS	L1
writing highly tested software	S1
unit testing	K09
integration	S4
defining and modelling a consumable api	S4
work autonomously	A1
energized by missions and goals	S4
designing	K02
analyzing	K02
optimising code	K04
troubleshooting large-scale distributed systems	S4
python	S1
django	K09
docker	S4
orm	K06
sqlalchemy	K09
python	S1
django	K09
docker	S4
orm	K06
sqlalchemy	K09
lead the design & implementation	S4
back-end services	K04
drive the implementation of new forecasting algorithms and tooling	S4
responsibility for live productions systems	S4
perform developer tests	S4
peer code reviews	K02
prepare strong documentation	S4
develop tools	S4
improve and maintain components & systems	S4
python	S1
back-end programming	K04
database structures	K02
webapp design	K02
python	S1
orms	K09
Django	K02
ORM	S1
SQLAlchemy	K02
designing & implementing distributed system architectures and apis	S4
docker	S4
deploy your applications	S4
computer engineering	K02
manage individual priorities deadlines and deliverables	S4
contribute to engineering efforts	S1
solve complex engineering problems	S4
get-things-done attitude	S1
identify shortcomings quickly	S4
statistical modeling	K02
optimization problems	S4
work with many different stakeholders	S1
english	L1
eu/efta or swiss work permit	S1
information technology	K02
online travel	S4
java	L1
web-services	K05
python	S1
distributed-system	S4
amazon-web-services	K03
information technology	K02
online travel	S4
java	L1
web-services	K05
python	S1
distributed-system	S4
amazon-web-services	K03
java	L1
python	S1
Docker	K04
AWS	S1
hadoop/spark	K01
sql	S1
airflow	S4
Jupyter	K09
agile/lean	S4
base your decisions on solid data and metrics	S4
produce outstanding work	S4
break challenges into bite-size tasks	S4
mentor team mates	S4
demand quality	S4
machine learning	K01
cloud services	S4
apis	K04
developing a whole range of key product features	S4
defining and implementing services	S4
collaborate with product engineers	S1
accountable for your own projects	S4
trusted to deliver	S4
form part of a broader team	S4
takes collective responsibility	S1
making success happen	S1
mobile application	K09
android	K02
mobile	K09
kotlin	K02
architect	K02
build	S4
maintain	S4
tackle challenges	S4
find creative ways to implement new features	S1
Kotlin	K09
RxJava	K09
Couroutines	K01
share your knowledge	S1
keep up the high level of quality	S4
reviews	K01
pairing	S4
mentoring	K04
focus on a top-notch user experience	S1
make the app context aware	S4
google awareness api	K09
improve of our sync framework	S4
build features	S4
location based services	S4
design	K02
ui	K06
ux	S1
mobile technologies	K02
mobile wallets	K03
android sdk	K05
coding	K02
Kotlin	K09
solving technical challenges	S1
ios app	K06
backend development	K09
degree	K01
computer science	K05
android	K02
payment	S4
loyalty	A1
shopping	K02
eCommerce	K02
internet marketing	S4
java	L1
spring	S4
node.js	S1
reactjs	K06
high-quality well-tested and scalable code	S4
ensure code quality and maintainability	S4
evolving architecture and tech stack	S1
code reviews	K02
refactoring	K04
standards	K01
improving build and test systems	S4
coach guide and mentor teams	S4
architecture	K02
technology	K02
collaborate	S1
identifying managing and minimizing technical debt	S4
share architecture knowledge findings and standard methodologies	S1
java	L1
spring framework	S4
web technologies	K01
( non- ) relational databases	S4
node.js	S1
react	S1
design implementation and operation of distributed services and apis	S4
strategic thinker	S4
analytical	K09
critical thinking	S1
frame problems	K02
drive teams	S4
collect data	S1
guide the analysis	S4
present the data	S1
influence leadership	S1
agile software development	S4
product discovery	S4
continuous deployment	S4
aspiration for quality	S4
sense of pragmatism	S4
quality assurance	S4
quick adoption of new technologies	S1
speak at conferences	S1
engage in the community	S1
english	L1
communication	S1
