bredtorienteret	A1
varetage opbygning og drift af servicefunktioner	S1
indgå i et team	A1
alsidig	A1
renovering- og restaureringsopgaver	S1
Reperationsarbejder	A1
Flisearbejder	A1
Tagarbejder	A1
imuring af rygninge og grater	A1
fagudlært murer	S1
brænde for dit fag	A1
arbejde selvstændigt	A1
kundemindet	A1
arbejde sammen på tværs af faggrænser	S1
kørekort b og gerne be	S1
ledelseserfaring	A1
kvik	A1
arbejde selvstændigt	A1
kan lide at have travlt	A1
min tid	A1
arbejde med komplicerede patientforløb	S1
omsorg	A1
kol-team	A1
diabetes mellitus	A1
kol	A1
niv ( non invasiv ventilation	S1
lomholt-system	A1
clinical suite	S1
engageret	A1
korrespondance	A1
post	A1
arkivering	A1
bogføring	S1
regnskabsmæssige opgaver	S1
personalerelaterede opgaver	S1
administrativt sagsarbejde	S1
indkøb af kontorartikler	S1
vedligeholdelse af intranet og hjemmeside	S1
kontoruddannet	A1
it	A1
bogføring	S1
arbejdet i en kommune	A1
åben	A1
udadvendt	A1
bevare overblikket og begge ben på jorden	A1
velformuleret	A1
omstillingsparat	A1
fleksibel	A1
godt humør	A1
opus	A1
skrivning af notater i opus fra mirsk	S1
MIRSK	A1
opus	A1
ris	A1
LABKA	A1
indkaldelse af patienter	A1
finde journaler frem til ugeprogram	S1
oplæring af elever	S1
Officepakken	A1
GSÅben	A1
opus notat	S1
epikrise	A1
MIRSK	A1
orbit	A1
Labka	A1
ris	A1
godt humør	A1
kan lide at have travlt	A1
robust	A1
arbejde i et team	A1
en 473/	A1
endoskopi	A1
Olympus Iplex	A1
selvstændigt	A1
rejsevant	A1
bidrage til fremtidig udvikling?	A1
dygtigste	A1
effektive	A1
strukturerede	A1
herlig men stærk og udadvendt kommunikerende personlighed	S1
godt humør	A1
let til smil	A1
går altid foran med dit eksempel	A1
høj stresstærskel	S1
have mangebolde i luften	A1
initiativrig	A1
løsningsorienteret	A1
effektiv	A1
bevare overblikket	A1
struktureret	A1
trives i travl omskiftelig hverdag	A1
lagererfaring	A1
rengøringsartikler	A1
ledererfaring	A1
klar til en stor udfordring	S1
jernvilje	A1
personligt drive	A1
få styr på lageret	A1
deltager aktivt i den daglige drift	A1
varemodtagelse	S1
pluk og pak	A1
forsendelse	A1
rengøring i butik ,slagter og bager	S1
stabil	A1
grundig	A1
Kvalitetsbevist	A1
Serviceminded	A1
arbejde selvstændig og i team	A1
dansk	A1
øge kvaliteten	A1
sænke omkostningsniveauet	A1
ledererfaring	A1
økonomi	A1
it og statistik	S1
løn- og personaleadministration	S1
realisere visionen	A1
sikre en stærk ledelse af myndighedsopgaverne	S1
varetage dialogen	A1
løn og personale	S1
regnskab	A1
ledelsesinformation	A1
it	A1
strategisk sans	A1
ledererfaring	A1
akademisk uddannelse	S1
lederuddannelse	A1
forretningsforståelse	A1
levere stærke strategiske bud	A1
udadvendte facon	S1
personlige pondus	A1
skabe gode relationer til samarbejdspartnere	S1
fastholde en naturlig gennemslagskraft	S1
skabe et inspirerende arbejdsmiljø	S1
motivere dine medarbejdere	S1
levere synlige resultater	S1
dygtig	S2
engageret	A1
frisk	A1
engageret	A1
udadvendt	A1
godt humør	A1
klar til at lære nyt	A1
arbejde med computer	A1
servicere vores web-butik	A1
service og kvalitets orienteret?	A1
serviceminded	A1
selvstændig	A1
ansvarsbevidst	A1
Diners	A1
Eurocard	S1
Fakturere	A1
fakturere samt følge op på debitorer	S1
bogføre indbetalinger	A1
have overblik over de forskellige konti for caféerne	A1
videreudvikling at rutiner og systemer	A1
regnskab	A1
administration	A1
giver venlig service overfor vores leverandrøre medarbejdere	S1
bevarer overblikket i hverdagen	S1
arbejde selvstændigt	A1
god til at samarbejde	S1
office-pakken	A1
har lyst til forandring udvikling	S1
bevare overblikket i stressede situationer	S1
forene basal sygepleje og højteknologi	S1
arbejde bevidst med faglige og personlige kompetencer	S1
handlekraftig	A1
påtage dig ansvar	S1
være i meget tæt kontakt med patienter og pårørende	S1
turde gøre en forskel	S1
blive udfordret på etiske overvejelser	S1
bidrage til udvikling af sygeplejen	S1
gå i front	A1
gå på akut kald	S1
samarbejde på tværs af et stort hospital	A1
telefonisk kundeservice og salg	A1
flair for it	S1
høj stress tærskel	S1
skarp i en dialog	A1
salgsminded	A1
tager ejerskab over dit arbejde	S1
vælger at se udfordringer/problemstillinger fra den mest positive vinkel	A1
energisk	A1
villig til at arbejde hårdt og målrettet	S1
vinder og konkurrence menneske	A1
etik	A1
kundeservice	S1
kvalitetsbevidst	A1
stabil	A1
kold og varm madlavning	A1
opfyldning af buffet	A1
køkken	A1
kantine	A1
hygiejnebevis	A1
fleksibel	A1
udadvendt	A1
præsentabel	A1
tager nye udfordringer med et godt humør	A1
lede og koordinere de mange forskellige vejledningsopgaver	S1
indskrivning	A1
fastholdelsessamtaler	S1
kurser	A1
samarbejde med lærere og administration	S1
telefon- og træffetid	S1
planlægning og evaluering af kursustilbud	S1
uddannelsessektoren	A1
samarbejds- og organisatoriske evner	S1
bevare overblikket	A1
godt humør	A1
varetage den kliniske uddannelse af sygeplejestuderende	S1
varetage den kliniske uddannelse af 4-6 sygeplejestuderende pr	A1
bedside-undervisning	A1
planlægge og afvikle individuelle kliniske uddannelsesforløb	S1
planlægge og gennemføre studiesamtaler	S1
vejlede og eksaminere ved interne prøver	S1
planlægge og gennemføre opfølgningsmøder	S1
fastholde og videreudvikle et lærings- og studiemiljø hvor refleksion vejledning og undervisning er i fokus	S1
informere og ajourføre afsnittet om udviklingen indenfor sygeplejerskeuddannelsen	S1
dansk autorisation som sygeplejerske	S1
pædagogisk efteruddannelse svarende til 1/6 diplom	A1
sygeplejerskeuddannelsen	A1
engagement og interesse indenfor det kliniske såvel som pædagogiske felt	S1
kliniske såvel som pædagogiske felt	S1
debitor- og kreditorstyring	A1
kontering og bogføring af bilag	S4
afstemning af kasse og bankkonti og øvrige mellemregningskonti	S1
Momsindberetning	A1
kontrol og frigivelse af lønbilag	S1
regnskabsmæssig forståelse	A1
navision stat	S1
statens lønsystem	A1
arbejder med kontaktpersonsfunktion	S1
arbejder jeg-støttende	S1
arbejde med mennesker med en psykisk sygdom	S1
arbejde i et tæt tværfagligt samarbejde	S1
arbejde selvstændigt	A1
træffe de nødvendige beslutninger	A1
bevist om sin måde at kommunikere på	S1
praksisnærhed	A1
faglighed	S1
videreudvikling	A1
kvalitetssikring	A1
undervise	A1
Erhvervsøkonomi	A1
salg og service	S1
Samfundsfag	A1
it	A1
undervise	A1
administration	A1
økonomi	A1
ha	A1
cand.merc	S1
undervise	A1
tysk	A1
engelsk	A1
dansk	A1
Samfundsfag	A1
ba	A1
uddannelses på kandidatniveau	A1
dygtig	S2
engageret	A1
har lyst til at undervise	S1
teamorienteret	A1
indstillet på tværfagligt samarbejde	S1
humor	A1
humanistisk livssyn	A1
udadvendt	A1
skabe relationer	S1
ser forandringer og udviklingsmuligheder som en udfordring	A1
helhedsorienteret	A1
pædagogikum	A1
værtskab	S1
service	S1
kontakt til vore mange gæster	S1
gøre en positiv forskel	S1
professionel servering	A1
a la carte	A1
selskab	A1
vejlede gæster i valg af menu og vine	S1
skabe resultater som kan ses og mærkes	S1
fagligt stolt	A1
sætter en ære i at vore gæster får de bedste personlige oplevelser	S1
sælgende	A1
kontaktskabende	A1
velsoigneret	A1
smilende	A1
god fysik	A1
bevare overblikket i stressede situationer	S1
samarbejde på tværs af afdelinger og faggrupper	S1
ser en fordel i at have et varieret arbejdsskema med skiftende arbejdstider	S1
anerkendende	A1
imødekommende	A1
indgå i et tværfagligt team	A1
direkte plejerelateret opgaver	S1
opvarmning og anretning af aftensmad	A1
arbejde med ældre borgere på midlertidigt ophold	S1
arbejde ud fra en helhedsorienteret vinkel	S1
samarbejder ud fra et anerkendende fokus	S1
bevare roen og overblikket	A1
smilende	A1
fleksible	A1
hjælpsomme	A1
smager på maden	A1
dyrke madglæden og de gode råvarer	S1
mellemstort køkken	A1
Helsingør	A1
positiv af sind	A1
hjælpsom	A1
finder løsninger selvom du er presset	A1
fleksibel	A1
ser mulighederne i et frit samarbejde	A1
bespise alle slags mennesker	A1
opfordrer børnene til at være hjælpsomme hensynsfulde og positive	S1
styrke gruppefællesskabet	A1
giver børnene mulighed for medbestemmelse	S1
alsidig	A1
aktiv	A1
positiv	A1
samarbejdsorienteret	A1
godt overblik	A1
skabe en tryg og udviklende dagligdag for børnene	S1
brænder for sit fag	S1
musik	A1
natur	A1
udeliv	S1
orientere sig	A1
arbejde med it som værktøj	S1
fagligt velfunderet	A1
reflektere over din praksis	S1
opstilling af regnskaber/årsregnskaber	S1
revision	A1
moms	A1
daglig kontering	A1
kommunikation og it	A1
informatik	A1
programmering	A1
medialogi	A1
tages højde for elevens selvstændighed og personlige udvikling	S1
undervisning og planlægning i et tæt teamsamarbejde	S1
cand.scient i informatik	S1
cand.mag i multimedier humanistisk informatik	S1
computerspilsbranchen	A1
PG/pædagogikum	S1
interaktive medier	S1
programmering	A1
gamification	A1
computerspilsudvikling	A1
skabe tillid og kontakt til unge mennesker	S1
naturlig autoritet	A1
let ved at sætte rammer for det faglige samvær med eleverne	S1
samarbejde med kollegerne	S1
kreativ	A1
innovativ	A1
respekt for menneskers forskelligheder	A1
påvirke andre på en positiv måde	S1
grafiske evner	S1
kvalitetssikring af grafisk materiale	S1
sammensætning af 360-billeder	A1
efterbehandling af corporate billeder	S1
billedredigering	A1
InDesign	S1
photoshop	A1
detaljeorienteret	A1
effektiv	A1
arbejder selvstændigt	A1
arbejdsmoral	A1
billedbehandling	A1
fagligt dygtig	A1
engageret	A1
arbejdsmarkedspolitik	S1
statistik	A1
samfundsøkonomi	A1
stud.polit	S1
stud.scient.oecon	S1
stud.ha	S1
stærk faglig profil	S1
fordyber dig i og tager ansvar for de opgaver du stilles overfor	S1
analytiske og metodiske færdigheder	S1
skriftlige formidlingsevner	S1
kvantitative analyser	A1
arbejde dybdegående med empiriske og statistiske analyser	S1
skabe grundlag for fremtidens politikudvikling	S1
kvantitative og statistiske evalueringer	S1
analyser med brug af individdata	S1
sas	A1
statistiske værktøjer	S1
behandling af store mængder data	S1
gåpåmod	A1
arbejde med empirisk metode	S1
koble resultaterne til den økonomiske teori	S1
”ole opfinder”	A1
svejse	A1
arbejde selvstændigt	A1
flair for teknik	S1
”regne den ud”	A1
udvikle / designe / samle / svejse en kabine	A1
pp tråds hånd svejser	S1
indgå i et samarbejde	A1
trykning af ekstrakter	A1
kopiere ankesagens dokumenter	S1
vedligeholdelse af tjenestekøretøjer	S1
opsætning af udstyr	S1
papir- og affaldshåndtering	A1
sikre kvalitet og effektivitet i vores sagsbehandling	S1
gode evner for samarbejde	S1
serviceminded	A1
robust	A1
engageret	A1
stabil	A1
ansvarsbevidst	A1
pligtopfyldende	A1
udfører dine opgaver med høj kvalitet	A1
situationsfornemmelse	S1
fleksibel	A1
overkomme fysiske arbejdsopgaver	S1
godt humør	A1
kørekort til personbil b	A1
afholde status	S1
plukkes	A1
pakkes	A1
fysik i orden	A1
fysisk arbejde	A1
går engageret til dine arbejdsopgaver	A1
stabil	A1
pligtopfyldende	A1
går op i detaljen	A1
effektiv	A1
engelsk	A1
ordenssans	A1
grundig i dine arbejdsopgaver	A1
god fysik	A1
fysisk arbejde	A1
sætter borgeren i centrum	S1
lære nyt	A1
humoristisk sans	A1
samarbejde	S1
lungemedicin	A1
varetage specialiserede og almene lungemedicinske opgaver	S1
videreudvikle området	A1
bidrage på visionærvis og aktivt til at udvikle specialet yderligere	A1
indgå engageret i både videreudvikling og drift af det lungemedicinske speciale	S1
understøtte en kultur hvor der lægges vægt på et godt og dynamisk arbejdsmiljø	S1
kommunikative egenskaber	S1
samarbejde tværfagligt	A1
bidrage aktivt til forskning uddannelse og kvalitetsudvikling	S1
gå aktivt ind i afdelingens kvalitetsarbejde	S1
optimering af patientforløb og patient- og pårørendeinvolvering	S1
jordemoderfaget	A1
konsultationsarbejde	S1
barselsklinik	A1
ammeklinik	A1
fleksibel	A1
hjælpe med at passe svangre- og barselspatienter	A1
hjælper hinanden på tværs af afsnittene	S1
klinisk sparring	A1
vejlede studerende	S1
deltage i projektarbejde	S1
stan certificeret	A1
jordemoderfaglig visionær	S1
pædagogiske empatiske og kommunikative evner	S1
Glad	A1
imødekommende	A1
initiativrig	A1
fleksibel	A1
omstillingparat	A1
arbejde med at udvikle samt forbedre klinisk praksis	S1
forsknings- og udviklingsarbejde	S1
patientsikkerhed	A1
patientinvolvering	A1
rationel drift	A1
rengøring	A1
tøjvask	A1
udviklingsorienteret	A1
planlægge en inklusionsårsplan	S1
være en del af skolens ressourcecenter/pædagogisk læringscenter	S1
samarbejde med lærere elever forældre ledelsen samt øvrige eksterne samarbejdspersoner	S1
godt funderet skriftligt og mundtligt	S1
inklusionsfremmende aktiviteter	S1
arbejde selvstændigt og tværfagligt	S1
sætte din viden i spil i forhold til kolleger med forskellige faglige baggrunde	S1
mangfoldighed	A1
fællesskaber	A1
inkluderende læringsmiljøer?	S1
inkluderende læringsmiljøer	S1
omsorg	A1
kontakt	A1
udvikling af børnenes muligheder for at deltage i læringsfællesskaber ( leg klasse- og læringsrummene frikvarter	S1
være en del af skolens ressourcecenter/pædagogisk læringscenter	S1
udvikler en observations- og sparringskultur	S1
støtte lærerne forældrene og eleverne i et struktureret og forudsigeligt læringsmiljø	S1
sparring med lærerne	S1
stimulering og udvikling af fællesskab sociale og personlige kompetencer hos eleverne	S1
understøtte enkelte eller grupper af elever	S1
social træning	S1
samarbejde tæt med en række af skolens lærere	S1
arbejde med retningslinjer for datamodellering	S1
datamodellering	A1
gøre en forskel	S1
udnytte værdien af store datamængder optimalt?	S1
tænker strategisk	A1
arbejde med model- og datastandarder	S1
arbejde i tæt samspil med it-arkitekter og udviklere	S1
designe og optimere løsninger på vores nye dataplatform	S1
designe og implementere værdiskabende datamodeller	S1
udforske analytiske muligheder	S1
rådgive og støtte organisationen i strategisk anvendelse af data	S1
implementere og vedligeholde governance	S1
definere metoder og processer for udvikling og drift	A1
udvikle og implementere strategi og roadmap	S1
designe og kommunikere standarder for datamodellering og metadataregistrering	S1
støtte og køre vores data governance-program	S1
igangsætte nødvendige initiativer i projekterne	S1
engagere dig i datakvalitetskontrolprocesser	S1
dokumentere og vedligeholde fysisk og logisk dataarkitektur	S1
understøtte daglige issues vedrørende datadokumentation	S1
etablere og vedligeholde reference- og løsningsarkitektur	S1
målbilleder	A1
guidelines	A1
principper	A1
udnytte data på nye måder	A1
arbejde dedikeret	A1
sikre effektiv udvikling af værdiskabende løsninger	S1
information/data	A1
processer	A1
dataintegrationer	A1
implementering af nye it-løsninger	S1
arbejde på et højt abstraktionsniveau	S1
designe og/eller omsætte tekniske beskrivelser og behov til tekniske og datamæssige løsninger	S1
samarbejde	S1
sikre den nødvendige koordinering og videndeling	S1
formidler	A1
holder hovedet koldt i pressede situationer	S1
arkitektur	A1
data	A1
ny teknologi	A1
mod på at lære nyt	A1
arbejde projektorienteret	A1
Datamodelleringskoncepter	S1
data vault	A1
Snowflake	A1
3	A1
datamodeller på bl.a	S1
xml	A1
CSV	A1
AVRO	A1
PARQUET	A1
Arkitekturrammeværk	S1
zachman framework	A1
Datamodelleringsværktøjer	S1
ea sparks	A1
Qualiware	A1
Datakvalitetskoncepter	S1
cloud-baseret it-arkitektur eller udvikling	S1
etl	A1
data lake	A1
metadata registrering og lineage	S1
design af løsninger i en offentlig kontekst	S1
fda	A1
OIO	A1
opbygning af data flows	S1
sikre beboerne en høj livskvalitet	S1
omstille dig til nye rutiner	A1
deltage i dækningen af vagter ved sygdom	S1
arbejde med plejen af ældre	S1
arbejde med at dokumentere	S1
KOS2	A1
betjene psykiatrisk center	S1
tjeneste	S1
udadvendt	A1
energi- og kraftværksområdet	A1
projektledelse af teknisk komplicerede og udfordrende energianlæg	S1
-biomassekonvertering af fossilfyrede kraftværker	S1
-optimering af kraftværker og anlæg	S1
-projektering af nye kraftværksanlæg	S1
-drift- og vedligeholdelse af anlæg	S1
task force indsats	S1
haverier	A1
due diligence projekter	S1
feasibility studier	S1
strategi indsatser	S1
arbejde tæt sammen med kunder	S1
opbygge gode relationer til netværk	S1
arbejde i et dynamisk miljø	A1
interesse for at udvikle dig	A1
energi	A1
kraftværker	A1
miljø	A1
energiområdet	A1
projektledelse	S1
energiområdet	A1
byggeri og anlæg	S1
strukturere projektets faser	S1
sikre effektiv projektafvikling	S1
projektering/projektledelse	S1
komplette projektforløb	S1
planlægning	A1
projektering af anlæg	S1
udbud samt tilsyn	A1
projekt- og byggeledelse	S1
kraftværker	A1
miljøanlæg	A1
kontekst- og forretningsforståelse	A1
arbejde systematisk	A1
arbejde i et internationalt miljø	S1
dansk	A1
engelsk	A1
frisk sælgende personlighed?	S1
kontakte virksomhedsledere og andre ansættende ledere i mindre og mellemstore virksomheder	S1
arbejder selvstændigt	A1
højt aktivitetsniveau	A1
salgsdialoger	A1
skaffe nye kunder i butikken	A1
god energi	A1
indstilling til at ville lykkes	A1
vindermentalitet	A1
motiveres af et ja tak	A1
ikke lader dig slå ud af et nej tak	S1
social	A1
skaber en god stemning	S1
New Bizz	A1
bagerfaget	A1
kvalificeret	A1
energisk	A1
reservedels indkøb håndtering udlevering og salg	A1
værkstedsplanlægning	S1
indskrivning	A1
skadekoordinering med eksternt pladeværksted	S1
telefonekspedition	A1
Engageret	A1
selvstændig	A1
ansvarlig	A1
serviceminded	A1
Dracar+	A1
Suzuki	A1
sælge produkter	A1
tillid	A1
loyalitet	S1
smil	A1
positiv energi	A1
samarbejde	S1
koordinering	A1
positiv indstilling til samarbejde problemløsning og tilgang til andre mennesker	S1
pet/ct	A1
spect	A1
fysiologi	A1
kombinere fysiologi med anatomi	S1
anatomi	A1
diagnostik	A1
stadieinddeling af sygdomme	A1
terapimonitorering	S1
matematiske begavelse	S1
visuelle betragtende hjerne	A1
behandling med radioaktive lægemidler	A1
visitation	S1
beskrivelser af forskellige typer undersøgelser	A1
fysiologisk og/eller medikamentel belastning af hjertet	S1
hjerteperfusionsundersøgelser	S1
klinisk fysiologi	A1
nuklearmedicin	A1
abcde principperne	A1
måle værdier	S1
måle crp hæmoglobin og leucocyter	A1
stixe urin	A1
tage dyrkninger	S1
sonde	A1
urin-kateter	S1
pvk	A1
CVK	A1
sc-nål	A1
hjerte lunge speciale	S1
forebygge indlæggelser	S1
sikre tæt samarbejde med relevante samarbejdspartnere	S1
skabe høj kvalitet i borgerens behandlingsforløb	S1
understøtte en ensartet og høj kvalitet på tværs af sektorer	S1
sektorovergange	A1
relationskompetencer	S1
faglig nysgerrighed	A1
varetagelse af sygeplejeopgaver	S1
håndtering af ustabile borgere	S1
arbejde løsningsorienteret	A1
arbejde selvstændigt	A1
tage beslutninger i pressede situationer	S1
fejlfinding på og reparation af produktionsmaskiner	S1
forebyggende vedligehold	A1
planlægning af større eftersyn	S1
tilsyn og planlægning af arbejdsopgaver for eksterne håndværkere	S1
optimering af produktionsudstyr	A1
projektarbejde	A1
teknisk profil	A1
el arbejde	A1
procesteknisk forståelse	S1
større rørinstallationer	A1
regulering af tryk og flow	S1
el-styringer	S1
industrigasser	A1
prioritere	A1
planlægge	A1
overblik	A1
arbejder struktureret og pligtopfyldende	S1
kommunikations- og samarbejdsevner	S1
positiv	A1
engageret	A1
arbejder selvstændigt og kvalitetsbevist	S1
fokus på overholdelse af deadlines	S1
bidrager til et højt sikkerhedsniveau	S1
godt humør	A1
søge og dele viden	S1
engelsk	A1
it	A1
inspirere	A1
udfordre	A1
rumme	A1
aktiv medspiller	A1
anerkende tilgang	A1
respekterer og gerne udfordrer kollegers idéer og pædagogiske arbejde	S1
ledelse	A1
personaleledelse	S1
samarbejde	S1
drive og videreudvikle et rigtig godt børnehus	A1
trivsel	A1
lede en integreret institution	S1
faglighed	S1
lytte	A1
reflektere	A1
omsætte visioner til handling	S1
lydhør	A1
inddrager kolleger	S1
træffe beslutninger	A1
gå forrest	A1
overblik	A1
rummer samtidig nærvær og de små detaljer	S1
arbejde videre med mange af de tiltag vi allerede har i gang	A1
inspirerer også til kommende tiltag	S1
synlig i huset	A1
trives med de forskellige aspekter jobbet byder på	S1
ledelsesopgaver	S1
dialogbaseret	A1
anerkendende	A1
videreformidle	A1
inspirere	A1
kommunikerer ligeværdigt imødekommende og med tydelighed	S1
it-systemer	S1
humor	A1
humør	A1
skabe det gode børneliv	S1
indgå i et mindre sjak	A1
vejen som arbejdsplads	S1
kloak	A1
fiber	A1
fjernvarme	A1
Håndmandsarbejde	A1
vejen som arbejdspalds	S1
fjernvarme	A1
kloak	A1
fiber	A1
dansk	A1
troværdigt og inspirerende sætte retning	S1
stå i spidsen	A1
skabe engagement og følgeskab	S1
skabe en stabil og autentisk forbindelse	S1
sætte dagsordenen	A1
være værdiskabende	S1
levere skarpt fagligt og strategisk med- og modspil	A1
matche kravene til ledelse af den faglige indsats forhandlinger håndtering af vanskelige sager	S1
lang videregående uddannelse	A1
juridisk kompetence	A1
robust	A1
gennemslagskraft	S1
direkte ledelse	A1
ledelse af ledere	S1
ledelse	A1
personalejura	S1
arbejdsmiljø	S1
kompetence- og organisationsudvikling	S1
tillidsfuldt og konstruktivt samarbejde	S1
integritet	A1
ordentlighed	A1
loyalitet	S1
sikre såvel kompetent ledelse udvikling og styring af egen afdeling som den tværgående strategiske udvikling af hele organisationen	S1
hr-området	S1
telefonkontakt internt og eksternt	S1
administration for caféerne	A1
behandle og bogføre diners eurocard og pbs	S1
kronisk medicinsk speciale	A1
