design and refine every touchpoint of the customer journey	S4
design and refine every touchpoint of the customer journey	S4
tackling new problems and perspectives	S1
designing tools materials and stimulating content	K04
drive internal strategy and innovation	S4
CX	K09
content output	K04
impact technology can have on customers	S1
deliver a meaningful member experience	A1
researching and defining opportunities	S4
conduct interviews	S4
bring customer experience to life	S1
creating content	K04
deliver clear and attractive design outcomes	S1
defining our product roadmap	S4
delivering the right products and services	S4
driven by purpose	S4
cx design methodologies	S1
user journey planning	K04
qualitative research methods	S4
eye for beautiful design	S1
passion for innovative solutions	A1
take sketches and paper prototypes through to high quality design output	S1
communicator	K04
articulate clearly and effectively	A1
working both independently	A1
leading on collaborative design discovery	S1
Keynote	A1
Figma	K09
illustrator	S7
google workspace	S1
work with business leads	S1
structure draft and negotiate agreements	S4
advise clients on the various legal risks business strategies and other issues	S3
commercial transactions	K04
business operations	S4
contract drafting	K04
negotiation	K09
advisory	S4
provide strategic business and legal advice	S4
develop a comprehensive long-term approach	S1
manage and resolve legal issues	S3
commercial transaction support	S4
LLB	K01
qualified lawyer in eu member state	S1
media	K02
publishing	K02
internet companies	S4
drafting and negotiating technology and content acquisition licensing and distribution agreements	S4
current media and digital platform landscape	S1
thrive in a fast-paced hard working environment	A1
complete projects in a timely fashion	A1
teach children	K01
applied behaviour analysis	S1
psychology	K09
natural enthusiasm and energy to work with children	S1
interpersonal and communication skills	S1
listen	A1
understand	S1
educate	K01
advise	S2
present	S4
work as part of a professional team	A1
taking direction from managers	S4
giving and receiving feedback	S1
complement teachers’ delivery of the national curriculum	S1
develop the skills and strategies of other support staff	S1
work collaboratively with teaching staff	S1
assist teachers	K04
management/preparation of resources	S4
encourage pupils	A1
provide support	S4
support the inclusion of the pupil	S4
implement changes instructed by the bcba	S4
interpret and analyse data	S1
provide constructive feedback	S4
improve the functioning of the programme	S4
maintain consistency	S4
data analysis	K09
liaise with bcbas	S3
communicating data to a bcba	S1
ensuring that the data files are up to date	S4
identify the need for prepare and maintain teaching materials resources and data sheets	S4
monitor progress	A1
reviewing acquisition data behaviour frequency maintenance and generalisation	S3
identify short-term targets	S1
provide 1:1 intensive teaching sessions	S1
aba	K02
provide 1:1 support	S4
principles of aba	S4
enable inclusion	S1
support the child to engage with others participate and generalise skills	S1
use behaviour management strategies	S1
contribute to a purposeful learning environment	S1
encourage the pupil to interact and work cooperatively	S1
understand and implement school child protection procedures	S1
comply with legal responsibilities	A1
provide 1:1 support using the principles of aba	S4
aba	K02
enable inclusion	S1
support the child to engage with others participate and generalise skills	S1
provide personal care	S4
teach independence using the principles of aba	S4
aba	K02
record progress data	S1
working with children with autism	S1
aba	K02
support a child to access the national curriculum using aba principles	S1
communicate in a polite and professional way	A1
communicate effectively	A1
provide a customer-oriented service	A1
QCF	K01
overseeing and managing a small consistent highly trained and motivated staff team	S4
delivering care and support	S1
delivering childcare	S1
focused on obtaining the best outcomes	S1
demonstrate good leadership	S4
organise and support staff	S4
deliver the best possible care	S1
making sure the manager is aware of any and all incidents	S4
supervise and mentor staff	S4
organise work patterns	S1
facilitate training	S4
involved in liaising	S1
access appropriate services	S1
promote professional good practice	S4
quality control monitoring	K04
social care and well-being act 2014	S1
regulation and inspection of social care act 2016	S1
ensuring the smooth running of your shift	S4
ensuring that high standards are maintained	S4
support residential care workers	S1
building a strong positive work ethic	A1
ensuring the home is physically safe	S1
assisting with health and safety responsibilities	S3
completion of corresponding records	S1
providing a good quality home environment	S4
creating and developing links between the community and the home	S4
enable children to participate fully in the life of the community	S1
assist in the completion of impact assessments	S4
matching documentation	K04
oversight of the placement of children and young people	S4
ensuring the assessed needs of young people in the home can be met	S4
administering a system for monitoring progress	S4
preparing or overseeing each individual placement plan	S4
reviewing such plans	S1
ensure children/young people are supported to achieve	S1
contribute effectively to each child's individual placement plan review	S1
supporting children/young people	S4
review process	A1
ensuring that there is a comprehensive plan in place	S4
assist when requested in the completion of the rota	S4
ensuring there are always staff available	S4
promote an open and supportive atmosphere	S4
identifying the training and development of staff	S4
meet the objectives	S1
induction supervision and appraisal of staff	S1
supportive	S4
offer constructive feedback to staff	S1
ensure that you keep and maintain accurate records	S4
managing and monitoring paperwork and records	S1
advising on best practice	S1
ensuring that services are delivered	S4
statement of purpose	S1
managing and operating budgets	S4
sourcing appropriate services	K04
support the childcare practices	S1
provide regular budgetary updates	S4
ensure children and staff are aware of all the procedures	S1
qcf level 3	K09
l5 in leadership and management in health and social care	S1
registration and inspection social care act 2016	K01
service requirements	S4
working in a care setting	S1
managing budgets	S4
taking part in an inspection	S4
reasoning numeracy literacy	S1
technology skills	A1
work as part of a team	A1
working closely with colleagues and other agencies	S1
solve problems	S1
work within the principles of the children’s act and social services and wellbeing act	S1
children’s act and social services and wellbeing act	S1
child protection issues and procedures	S3
manpower	A1
planning/development/skills mix	S1
develop and encourage professional growth in others	S1
budgetary requirement and management	S4
lead effectively	A1
leadership abilities	S4
organisation and leadership skills	S4
lead motivate and influence others	S4
interpersonal skills	S1
approachable	A1
honest	K01
reliable	A1
accountability	K10
be responsible for the work undertaken	A1
driving licence	S4
RGN	S1
RMN	K09
RNLD	K02
nmc pin	S4
NMC	K09
sen	K02
supporting sen pupils	S4
learning difficulties	S1
autism	A1
SEMH	K01
work in a variety of ages and abilities	A1
learn about the curriculum and teaching techniques	S1
sen	K02
asc	A1
supporting sen – asc & semh	S4
SEMH	K01
proactive	A1
committed	A1
enthusiastic	A1
supporting sen	S4
build strong and productive relationships	S1
motivated	A1
ambitious	A1
creative	K04
driven	A1
put a personal touch on the menu	S3
brunch trends	K02
american comfort food	A1
lead a small team	S4
kitchen's day to day operations	A1
stock control	K02
compliance	K04
gp control	S4
managing supervising and training your kitchen team	S4
ensure high standards of hygiene are maintained	S4
come up with different exciting and unique brunch and evening dishes	A1
demonstrate leadership	S4
menu planning	K04
coshh	K02
hse	K02
EHO	A1
food hygiene qualification	K01
mechanical background	S4
assembly	A1
workshop	K02
use hand tools	S1
work from drawings and works instructions	S1
follow health & safety guidelines	S1
show willingness to help out	S1
work ethic	S1
food service	K01
striving for the best	A1
deliver first class customer service	S1
delivering a professional service	S1
ensuring all guests are given a warm welcome	S1
displaying excellent product knowledge	S4
help guests make the best choices	S1
ensuring all guests are treated in a professional manner	S1
taking orders promptly	S4
answering queries	K04
ensuring all areas in the restaurant and bar are clean and tidy	A1
support the kitchen with food service	S4
ensure guests receive their food in a timely manner	S4
work on the bar	S4
creating coffees and hot drinks	S4
providing a professional bar service to guests	S4
moving large tray of vegetables	A1
manual handling tasks	S1
food preparation	S4
retail sales	S4
customer service	S4
winning attitude	A1
food preparation	S4
bread and cookie baking	K09
ensure food storage and preparation areas are maintained	S4
health & safety and audit standards	A1
comply with food code of practice	S1
till operator	S4
monitoring stock levels	S4
checking in deliveries	S3
complete daily and weekly cleaning schedules	A1
follow security & safety procedures	S4
maintain a safe working environment	S4
maintain high personal presentation	S3
work as a team member	A1
deliver a high standard of service	A1
serve and add value to customer needs	S1
ensure hygiene standards are met	S1
meet and greet guests	A1
deliver exceptional customer service	S1
using flt to move stock throughout warehouse	S1
loading/ unloading trailers	S4
use of hand scanners & pc’s	S4
physically fit	K09
time keeping	S1
hard working attitude	A1
english	K02
work as a team & alone	A1
flt counterbalance licence	S4
administration	S4
diary management	K04
typing of correspondence	S1
attending meetings	S4
sales support	S4
processing invoices	S4
producing sales quotations	S4
team player	A1
flexible	A1
assist	S1
it	K02
word	K02
excel	K05
outlook	K09
powerpoint	K02
communicator	K04
build and develop strong relationships	S1
english	K02
valid passport	A1
full driving license	S4
travel	K02
working in a small team	S4
enjoy a variety of tasks	A1
aptitude to hygiene	S1
produce brilliant creative copy	S4
adept at taking a strategic direction and bringing ideas to life through the written word	S1
defining the brand voice and developing it through use of language and tone	S1
detail-oriented	S1
meticulous	K09
uphold quality standards of style and grammar	S1
produce high-quality edited messaging and content	S1
manage your time effectively	A1
prioritize and manage multiple projects	S2
working collaboratively	S1
communicator	K04
contribute to the culture	S1
oral and written communication skills	S1
interpersonal skills	S1
interact with people at all levels	S1
copywriting skills	S1
confident yet sensitive interviewing skills	S1
sub editing	S1
proofing	S1
attention to detail	S4
manage own workload	A1
work to deadlines	A1
writing	K04
brand strategy	K04
brand campaigns	S1
pitches	S4
proposals	K10
social	K01
internal communication	S1
office	K06
g-suite	S3
InDesign	K04
illustrator	S7
Keynote	A1
marketing	K02
creative writing	K04
communications	S1
hard worker	A1
customer service	S4
communicate respectfully with clients and the public	S1
multi trades work	S1
rail	S4
full uk driving licence	S1
flexible	A1
carpentry	A1
bricklaying	K04
plastering	K09
concrete repairs	S4
paving	K09
painting	K09
replacing doors and windows	S4
cscs card	S3
certification of skilled trades	S1
tfl certificate	K09
ce ( class 1 ) licence	S4
cpc	S4
digital tachograph	K04
Tipper	A1
walking floor	S4
wtd's ( working time directive	S4
health & safety conscious	A1
flexible	A1
cpc driver qualification card	S4
digi-card	A1
licence - category c+e	K10
Tachos	A1
cscs card	S3
ppe	K01
CSCS	K01
providing a world class patient service	S3
liaising with the manager	S4
drive performance in the store	S4
leading and inspiring fellow staff	S4
ensuring the clinic runs successfully and efficiently	A1
providing patients with the best optical products	S4
dealing with any enquiries effectively	S4
fulfilling management duties	S4
store operations and dispensing duties	S3
business and marketing acumen	S4
deliver the best customer service journey	S1
running of the store	S4
reporting to management	K04
striving to meet targets	A1
driving performance and sales	S4
motivating and leading staff	S4
deliver exceptional patient care	S3
smooth running of the clinic	S3
managing fellow staff members	S4
communicating any ideas or concerns	S4
ensure the best performance and development	S4
challenging the team	A1
deliver the best service	S1
excel targets	S1
dispensing duties	S1
recommending frames lenses and contact lenses	S4
reception and admin work	S3
diary upkeep	A1
patient appointments	K09
recruitment	K04
upholding to nhs guidelines	S1
nhs guidelines	K01
maintaining presentation and visual aesthetics of the store	S4
promoting the business	S4
optical	A1
accountable for nominated clients	S4
maximise profits	S4
develop the business	S1
ocean import	K10
commercial mindset	A1
demonstrate & generate enthusiasm	A1
'can-do' attitude	A1
identify problems	S1
respond in a timely fashion	A1
demonstrate personal drive	A1
communicate effectively	A1
active listening	K04
smart	K09
enthusiastic	A1
web development	K04
html	K02
css	K02
less	K02
SCSS	K01
PostCSS	K09
angular	K02
react	A1
js	S1
java	K02
c#	A1
client-side compatibility	K04
performance considerations	K04
debug issues in a full stack environment	S4
sql	K02
team player	A1
engage with colleagues	S1
communication skills	S1
independently conduct the experimental work	S1
design execution and analysis of phosphoproteomics experiments	S1
phd degree	K01
mass spectrometry-based quantitative proteomics	S3
phosphoproteomics	K09
molecular biology	K09
vector construction	S4
protein synthesis in e	K09
post-translational modifications	S1
b	A1
english	K02
communication and collaborations skills	S1
independence	A1
paper and project writing	K04
designing existing transport construction maintenance processes	S4
work in a dynamic and international team?	A1
developing and illustrating processes and concepts	S4
transport installation and maintenance of wind turbines	S4
develop construction concepts	K04
ensure that market requirements and best practice is included	S1
drive new product development	S4
ensure full value chain perspective in new products	S4
optimize construction	S4
cost reduction	K04
quality improvements	S4
collection of improvement suggestions and best practice	S1
plan and ensure development of global construction work processes	S4
ensure that requirements from the operational business are included in the wind turbine & tools designs	S1
create new concepts for turbine installation	S4
optimize existing processes	S4
testing verifying at site	S4
production	S4
supply chain	S4
production	S4
installation	K02
maintenance	K04
B.Sc	S4
production mechanical electrical marine engineering	S4
lean	K09
value stream mapping	K04
process mapping ( production or development	S1
develop processes or concepts for larger components	S4
risk assessment tools	S1
PFMEA	S4
process mapping	K04
communication	S1
presentation skills	S1
english	K02
cooperating with colleagues	S1
proactive mindset	A1
keep an overview in stressed situations	A1
outgoing	K10
project management skills	K04
handle complex pricing calculations?	K10
communicate quantitative analyzes	S1
influence the sales of large-scale projects?	S4
supporting the electricity sales team	S4
pricing calculations competitor analysis	K10
benchmarks	K01
prepare pricing calculations and price-/cost analysis	S4
present the calculations	S4
prepare business cases and benchmarks	S4
support the sales strategies	S4
build and maintain a database of submitted offers/kpis	S4
analytical proactive and structured workstyle	A1
high-quality mindset	A1
numerate	S1
communicative skills	S1
interact with your commercial and technical colleagues	S1
working independently	A1
build relationships across the organization	S1
innovative	A1
solution-oriented	S1
masters degree	K01
finance	K10
economics	K01
pricing and complex analysis	K01
microsoft powerpoint	S1
excel	K05
visual basic	K05
pivot	K05
capex/opex business cases	K09
english	K02
danish	K02
swedish	A1
norwegian	K01
pig production	S4
feeding	S1
moving	A1
castration	K04
insemination	K09
monitoring the animals health	S4
driving license	S4
desire to work with pigs	S1
work closely with developers designers and marketers	S1
develop beautiful campaigns	S1
create outstanding experiences	S4
maintain our frontend stack	S4
contribute with beautifully crafted layouts	K04
scalable and modulable code	A1
developing and integrating great frontend experiences	S1
collaborate with a team of designers copywriters and marketers	S4
craft and deliver exceptional landing pages and experiences	K04
deliver maximum impact	S1
creative solutions and ideas	S4
solve challenges	S4
improve our overall website & campaign performance	S4
build and maintain a design system and development process	S4
markup	A1
javascript	K02
organize and maintain markup javascript and css	K04
css	K02
developing quality well-performing and scalable code	S4
javascript	K02
html	K02
css/sass	S1
git	K01
angular	K02
react	A1
typescript	K02
restful apis	S1
responsive design media queries	K04
adobe creative suite	S4
sketch	K04
invision	K01
wordpress/php	K04
scrum/agile	S4
general management and development of the employees	S4
budget and resource allocation	S4
ensuring timely and efficient project execution	K04
drive the development of technology	S4
master or phd degree	K01
chemical/biochemical engineering	K09
bio(chemistry	K09
food science	K01
project leadership	S4
interfaces between external/internal customers	S1
commercial insight	S4
production	S4
drive technological advances	S4
increase expertise level in the department	S4
lead and motivate people	S4
communication skills	S1
people management	S4
implementation of successfactors	S4
compensation and performance management	S4
optimize and manage existing reward and benefits programmes and processes	S4
support the business priorities	S4
ensure local compliance	S4
develop global frameworks policies and programmes	S1
manage hq reward programmes	S1
perform benchmarking	K01
market analysis	K04
drive the annual salary review	S4
benchmarking work for salary range setting	S4
advise and train managers and hr business partners	S4
support strong anchoring of rewards policies and programmes	S4
rewards in a global context	S1
delivering a broad range of reward initiatives	S1
masters degree	K01
business administration	K04
hr	K09
finance	K10
economics	K01
excel	K05
powerpoint	K02
working with numbers and data	S1
strong focus on details	S4
building relationship with your stakeholders	S1
engaging with colleagues	S1
english	K02
registered surgeon	S1
patient-centred	S1
inclusive	K02
provide your patients with a safe and effective course of treatment	S1
see it systems as an aid in your work	S1
good humoured	A1
loyal	A1
dedicated	A1
flexible	A1
engage people in the streets	S1
conveying knowledge	S1
Extroverted	A1
energetic	A1
excited about meeting new people	A1
enjoy interacting with many different characters	S1
result oriented	A1
work constructively towards reaching goals	S1
good at acquiring new skills	A1
continuously working on your own development	S1
english	K02
valid visa to work in denmark	A1
read and understand addresses and house numbers	S1
team work	A1
cooperation	K04
walk on stairs	S1
ride a bike	A1
acceptable criminal record	S3
read the latin alphabet	S1
motivated	A1
good structure	A1
follow a route	S4
register when a shipment is delivered	S4
work professionally with high quality	A1
reliable	A1
responsible	A1
trustworthy	A1
responsible	A1
conscientious	A1
work in all kinds of weather at night	S1
good colleague	A1
lead and implement an aligned strategy	S4
drive the digital supply chain community	S4
developing and implementing a digital supply chain strategy	S4
sharing best practice	S1
developing new initiatives	S4
identify digital supply chain initiatives	S4
collaborate with internal customers	S1
agile program management	S4
digital solutions	S4
ensure a continued support knowledge sharing across segments	S4
digital supply chain	S4
energetic	A1
willing	S4
find compromises between multiple and sometimes conflicting interests	S1
strategic mindset	A1
big picture thinking	A1
deep dive	A1
customer obsession	S4
deliver results	S1
ownership	S4
implementation	K09
digital savvy	A1
data analytics	K09
process transformation	K04
iot ( industrial automation	S4
e-commerce	S4
startups	A1
agile	A1
communication presentation and facilitation skills	S1
well-structured	S4
independent working style	K04
willingness to travel	A1
curious	K02
enjoy learning	A1
develop new ideas	S4
create value	S4
manage risk from the sale and purchase of power	S1
work both independently and collaboratively	A1
deliver team objectives	S1
coordinate tender responses	S1
participate in contract negotiations	A1
build and maintain good working relationships	S1
acquiring knowledge	S1
developing understanding	S1
support team activities	S4
business	K02
economics	K01
maths	S1
desire to learn and develop	S1
proactive	A1
commercially astute	A1
problem-solving attitude	A1
team player	A1
thrive in an international environment	S4
communicator	K04
english	K02
self-starter	A1
enjoy a fast-paced work environment	A1
market analysis	K04
communication and analytical skills	S1
insights creation and commenting	S4
creation/ optimization of ppt	S4
revising stimulus material for research projects	S4
analysis of quantitative data	S1
working with multiple data sources and combining them into relevant insights	S1
dialogue and follow-up with research vendors	S1
contribute to insights communication	S1
marketing	K02
marketing	K02
business	K02
cand.merc	K01
cand.negot	K01
cand.oecon	A1
marketing	K02
market research	K04
thinking visually	S1
communicate your ideas and messages	S1
ambitious	A1
goal oriented	S1
show engagement	A1
demonstrate positive thinking	S1
can-do attitude	A1
see great challenges in being tasked with tactical as well as strategic marketing problems	S1
business understanding	K04
strategic	S4
analytical	K04
communicative	S1
dive into the numbers	S4
analyze	A1
turn numbers into actionable insights	S4
ms office tools	S1
excel	K05
PPT	K01
SPSS	K01
structured working style	A1
take on task responsibilities	S4
contribute with ideas and input	S4
english	K02
picking and packing	S4
picking and packing orders with a hand scanner	S4
receiving and registering goods	S1
controlling returned goods	K04
palletizing and shipments	K04
perfectionists	A1
manual work	A1
precise	S4
goal oriented	S1
team players	A1
helpful	K02
show initiative	A1
transport	S4
logistics	K10
people management and development?	K10
motivate and set the direction	S4
ensuring the pace of production	S4
develop your team	S1
professional leadership	S4
set the direction	S1
coach and develop your team	S4
ensure that production runs in accordance with gmp	S4
gmp	K01
enabling your team to deliver in a timely and flawless manner	A1
run or participate in systematic problem solving	S1
science	K02
pharmaceutical production	K10
managing people	S1
management	K09
gaining trust and respect	A1
structured	K04
keep the overall view	A1
thrive in a busy and constantly changing working day	A1
prioritize	S4
communication and collaboration skills	S1
gmp	K01
lean	K09
work in a structured and targeted manner	A1
never compromise on quality	S4
ensure continuous improvements	S4
motivated	A1
ambitious	A1
reliable	A1
maintaining cell lines	S3
perform molecular biology techniques	S1
pcr restriction	K09
cloning reactions	K04
dna/rna and protein purification procedures	K09
setting up routine imaging and cell sorting experiments	S1
sample preparation	S4
assist with the overall maintenance of the lab	S4
administration of several databases	S4
plasmids	K09
cell lines	A1
mouse colony	K09
antibodies	K09
purchasing	K04
stocking	K09
participate in the research projects	S1
responsible for training and providing technical assistance	A1
tissue culture techniques	K01
cell sorting	K09
working independently and organized	A1
self-motivated	A1
interpersonal and communication skills	S1
danish	K02
english	K02
basic molecular biology	K09
mouse research	K04
increase the value of it systems	S4
maintain and develop effective relationships?	S1
working in a dynamic environment?	S4
support your colleagues	S1
computer equipment	S1
telephony	K09
application support	K04
familiarise yourself with your colleagues' situation	S1
use your service skills to assist them as efficiently as possible	A1
prioritise incoming requests	S4
tick each task off the list	S4
providing first-line support	S4
communicating with and informing users	S1
resolving technical it issues	S4
providing application support	S4
receiving recording and referring cases to the appropriate team	S4
accurately executing specified procedures	S1
co-operation	K09
communicator	K04
it support	S4
microsoft's systems	S4
itsm tools	S4
application support	K04
work independently	A1
seeing your duties through to the end	S1
take a structured approach to work	S1
prioritising your tasks and identifying those that are the most important	S4
thrive in an outgoing role	A1
communicate concisely and accurately	A1
providing the best possible service	A1
demonstrating persistence	S1
patience	K01
attentiveness	S4
enjoy working in a dynamic environment	A1
english	K02
security clearance	K04
drive development of the software product roadmap	S4
find innovative solutions	S1
stays on top of current trends	S1
develop long term plans	S1
embrace work load enthusiastically	S1
comfortable with a fast paced quickly changing work environment	A1
technical and business skills	S1
articulate the vision in the way others will understand	S4
project management	K04
b2b market	S4
ux	K04
development	K02
define value proposition customer segments and customer channels	S4
lead the product development process	S4
correctly brief the other departments	S1
challenge outcomes	S1
english	K02
czech	S4
product / project management	S4
ux development process	K04
user testing	K04
understanding the results	S4
communication skills	S1
passion for a change	A1
establish rapport	A1
bond with a business partner	S4
think outside the box	S1
clearly and professionally present information	A1
generation and development of new and existing business opportunities	S4
credible	A1
lead generation	K04
appointment setting	S1
proposal development and presentation	S4
manage the international sales	S1
international sales	S1
business development process	S4
building new business relationships	S1
building on existing success	S4
reporting to the head of sales	S4
build new major business opportunities	S4
sales canvassing	K04
develop implement and manage sales and relationships	S1
negotiate and close business	K01
exceed targets	K09
being in regular telephonic and face to face contact with clients	S1
generate leads	S1
market and client-research	K04
break into medium to large organisations	S1
manage and be part of all processes of a typical sales cycle	S1
monitor competitor activity and market dynamics	S4
recognise and recommend improvements to existing processes	S4
improve revenue performance	S4
inspiring	A1
persuasive	A1
convincing	K10
sales canvassing	K04
cold calling	S1
booking meetings on the phone	S4
outgoing	K10
javascript	K02
reactjs	A1
java	K02
javascript	K02
reactjs	A1
java	K02
solving business problems	S1
innovation and engineering practices	S4
apply your depth of knowledge and expertise	S1
software development lifecycle	K04
partner continuously with your many stakeholders	S1
stay focused on common goals	S1
motivated	A1
deliver of a next-generation analytics products	S1
bs/ba degree	K01
application data and infrastructure architecture disciplines	S4
architecture	K04
design	K02
developmental toolsets	S1
industry-wide technology strategies and best practices	S1
work in large collaborative teams	S1
achieve organizational goals	S1
building an innovative culture	S4
java	K02
javascript	K02
business analysis	K04
development	K02
maintenance	K04
software improvement	S4
html5	K02
javascript	K02
developing multithreaded scalable concurrent applications	S1
node js ( server side and tooling	S1
react	A1
java	K02
spring	K02
java-ee	K02
java	K02
spring	K02
java-ee	K02
solving business problems	S1
innovation and engineering practices	S4
apply your depth of knowledge and expertise	S1
software development lifecycle	K04
partner continuously with your many stakeholders	S1
stay focused on common goals	S1
bs/ba degree	K01
java	K02
spring boot	S1
nosql	K02
message	K04
cloud	K02
ci/cd	K10
application data and infrastructure architecture disciplines	S4
architecture	K04
design	K02
developmental toolsets	S1
industry-wide technology trends and best practices	S1
work in large collaborative teams	S1
achieve organizational goals	S1
building an innovative culture	S4
modern programming languages	S1
business analysis	K04
development	K02
maintenance	K04
software improvement	S4
financial technology	K10
saas	S1
wealthtech	A1
azure	S4
.net	K02
asp.net-web-api	S1
powershell	K02
json.net	K02
financial technology	K10
saas	S1
wealthtech	A1
azure	S4
.net	K02
asp.net-web-api	S1
powershell	K02
json.net	K02
open for continuous change	S1
automation	K09
azure paas	S4
microservices	S4
.net	K02
powershell	K02
ms sql	K04
ci	K02
azure paas	S4
enhance and maintain ci infrastructure pipelines and azure paas environments	S4
ensure on-going health and stability of pipelines across multiple environments	S1
azure	S4
administrate and manage azure resources	S4
subscriptions	K04
resource groups	A1
devops	K04
GitHub	A1
support developers	S4
troubleshooting deployed applications	S4
identify app issues vs configuration/environment issues	S4
enhance quality through pipelines	S4
usage of static analysis tools	S1
SonarQube	S4
.net analyzers	K04
infer#	A1
creating and maintaining build and deployment pipelines for web applications and services	S4
azure appservice	K04
iis	S1
sql dbs	K02
azure appservice	K04
troubleshoot azure appservice hosted websites and services	S4
identify app issues vs configuration/environment issues	S4
.net	K02
automation	K09
powershell	K02
azure cli	S4
json	S1
yaml	K01
based templates	S1
AppServices	K04
redis	K01
ServiceBus	A1
api management	K04
CosmosDB	K02
KeyVault	S4
azure sql	K04
sql scripts	K04
azure devops ( cloud and server	S4
docker containers	S4
K8s	K01
english	K02
financial services	K10
java	K02
reactjs	A1
web-services	S1
financial services	K10
java	K02
reactjs	A1
web-services	S1
solving business problems	S1
innovation & engineering practices	S4
apply your depth of knowledge and expertise	S1
software development lifecycle	K04
partner continuously with your many stakeholders	S1
stay focused on common goals	S1
bs/ba degree	K01
application data and infrastructure architecture	S4
architecture	K04
design	K02
software systems	K02
developmental toolsets	S1
industry wide technology strategies and best practices	S1
work in a co-located team	S1
achieve organizational goals	S1
building an innovative culture	S4
software skills	S1
business analysis	K04
development	K02
maintenance	K04
software improvement	S4
deliver high quality products	S1
java/j2ee	K02
python	K05
go	A1
react	A1
cloud technologies	S4
AWS	K02
containers	K02
Kubernetes	K02
devops for platforms	K04
automated testing	K01
resource management	K04
artificial intelligence	K04
computer graphics	S1
software development	K04
python	K05
artificial intelligence	K04
computer graphics	S1
software development	K04
python	K05
build highly efficient accurate and scalable computer vision and machine learning services	S4
computer science	K05
solve technical challenges independently	S3
python	K05
english	K02
good communicator	A1
enjoy working in a team	A1
postgresql	S3
Django	A1
PostGIS	K02
opencv	A1
NumPy	A1
shapely	A1
pyhon multithreading and multiprocessing	S1
aws/azure	S4
computer vision	S4
machine learning	K09
e-commerce	S4
open-source	S1
ruby-on-rails	A1
sql	K02
heroku	K09
e-commerce	S4
open-source	S1
ruby-on-rails	A1
sql	K02
heroku	K09
gather technical requirements	S4
architect solutions	S4
estimate timelines	K10
deliver and further develop applications	S1
communicate	S1
investigate	S4
celebrate	K10
reward	A1
promote	S2
TDD	K01
agile delivery	S1
teamwork	A1
automated testing	K01
code reviews	S7
pair programming	S1
qa	K01
pm support	K02
staying in touch	S1
ruby on rails	S1
TDD	K01
deploy apps	K04
Heroku	K09
AWS	K02
sql	K02
english	K02
agile/scrum	S1
working with 3rd party api’s	S1
performed code reviews	S1
Docker	A1
spree commerce	K09
leading a team	S4
contributions to open source projects	S1
e-commerce	S4
ElasticSearch	K04
Kubernetes	K02
financial services	K10
reactjs	A1
cloud	K02
python	K05
financial services	K10
reactjs	A1
cloud	K02
python	K05
deliver initiatives	S1
modernizing and transforming the platform	S4
work on a mix of front-end back-end and cloud technologies	S4
running with a full stack development	A1
java	K02
python	K05
react js	S1
Redux	K01
public and private cloud offerings	S1
data warehousing/etl	S4
fixed income instruments	S4
reference data	K09
django	A1
postgresql	S3
redis	K01
django	A1
postgresql	S3
redis	K01
build software	K04
help our customers	S4
build and expand our predictive analytics platform	S4
work with a tightly knit team	A1
enterprise resource planning ( erp	S4
point-of-sales ( pos	S1
identify problems	S1
run experiments	S4
deploy promising solutions to production	S4
develop interfaces to erp and pos software providers	S1
etl	K09
work on etl pipelines	S1
integrate our customers data bases	S1
work closely together with our machine learning	S1
effective communication	S1
documentation	K04
writing software with emphasis on quality testability and automation	S4
backend development	K04
python	K05
linux administration	S4
Docker	A1
ansible	A1
git	K01
Pandas	A1
Celery	K01
django channels	A1
django rest framework	S1
redis	K01
Nginx	K01
gitlab ci	K02
postgresql	S3
english on level c1	S1
honest	K01
trustworthy	A1
communicates openly	S1
Cybersecurity	K04
data & analytics	K09
digital marketing	K04
powerbi	K05
dax	K09
cloud	K02
data-modeling	K01
azure-analysis-services	S4
Cybersecurity	K04
data & analytics	K09
digital marketing	K04
powerbi	K05
dax	K09
cloud	K02
data-modeling	K01
azure-analysis-services	S4
building front-end layer	S4
design and build front-end / bi layer	S4
power bi reports	K04
dax queries	K04
azure analysis services models	S1
troubleshoot issues	S4
recommend optimizations	K01
tune solution / reports for better performance	S4
scrum meetings	S4
sprint planning	A1
code reviews	S7
power bi	K05
DAX	K09
data modeling	K09
cloud	K02
CICD	K01
devops	K04
agile	A1
english	K02
bachelor's degree	K01
azure analysis services	K04
agile software development	S1
financial technology	K10
agile	A1
architecture	K04
agile software development	S1
financial technology	K10
agile	A1
architecture	K04
making the right decisions	S4
definition & communication of “fit for purpose”	S1
describing a solution architecture	S4
aligning the teams around the technical orientation	S4
connects with the teams	S1
evaluate the different technical alternatives	S1
continuous exploration and innovation	A1
delivery to business ( d2b	S1
service to deliver ( s2d	S1
work in delivery to business ( d2b ) or service to deliver ( s2d ) context	S1
creating business enabler art epics	S1
software/system design and architecture	S4
design	K02
modelling	K09
documentation	K04
solution architecture	S4
programming languages	S1
analyzing strategic objectives	K04
defining specific goals	S4
it or engineering bachelor / master degree	K01
scaled agile ( safe	S1
analytical and problem-solving skills	A1
networking	S1
communication	S1
persuasion	K04
ability to persuade others	S1
build and maintain positive and trustworthy relationships	S1
share knowledge	S1
engage in discussions and group decision-making	S1
presentation skills	S1
assertive	A1
pro-active	A1
personal efficiency	S1
financial technology	K10
c#	A1
f#	K02
typescript	K02
financial technology	K10
c#	A1
f#	K02
typescript	K02
modern workflows and tooling	S4
maintain quality	S4
work with aws infrastructure	S1
producing cloud native software	S4
continuous integration	S4
automated testing	K01
domain modelling	K04
ubiquitous language	A1
logging	K04
serverless containerisation	K04
dev/prod environment parity	S1
experimentation	K10
c#	A1
f#	K02
typescript	K02
serverless framework	S1
functional programming	K04
Cypress	A1
Jest	S1
Nunit	K09
SpecFlow	K10
Expecto	A1
FsCheck	K09
canopy	A1
functions as a service	A1
hosting	K02
messaging	K04
relational and non-relational databases	S1
Loggly	A1
c#	A1
f#	K02
typescript	K02
problem solver	A1
curious about new technology	S4
functional programming	K04
12-factor app approach	S1
build cloud	S4
takes ownership	S1
learn as much as possible	A1
good listener	A1
able to explain concepts	S1
committed to improving yourself	A1
demonstrate interest in technologies that are beyond the scope of your daily workflow	S1
lazy	A1
don't like boring repetitive tasks	A1
outsource your labour to the compiler	S1
applying yourself to learning	S1
pragmatist	A1
qa	K01
testing	K04
cypress	A1
mocha.js	K04
chai	K01
qa	K01
testing	K04
cypress	A1
mocha.js	K04
chai	K01
introduce and implement the newest standards and testing solutions/automation	S4
product creation	S4
build and provide access to test environments and new features	S4
responsible for a successful product launch	A1
bring expert knowledge	S1
define testing standards and strategies	S4
create detailed comprehensive and well-structured test plans and test cases	S4
design develop and execute automatic tests	S4
conduct exploratory/manual tests	S1
identify record document thoroughly and track bugs	S1
work closely with the product team	S1
make new features testable	S4
improve tickets	S1
update product information	S1
facilitate test environments access	S4
quality assurance	S4
software qa methodologies tools and processes	S1
automated testing tools	S4
Cypress	A1
pytest	K01
truffle	S4
solidity	A1
coding/scripting	K04
devops	K04
build test environments	S4
CircleCI	A1
Docker	A1
work in an agile & energetic startup environment	S4
english	K02
collaboration tools	S1
computer software	K02
open-source	S1
testing	K04
qa	K01
automation	K09
software-quality	K04
automated-tests	S2
collaboration tools	S1
computer software	K02
open-source	S1
testing	K04
qa	K01
automation	K09
software-quality	K04
automated-tests	S2
ensuring high quality for customer-specific software projects	S3
analysis and risk assessment	K04
creation maintenance execution and documentation of ( automated ) tests	S4
collaboration in project teams	S1
communication with technical customer departments	S1
active support of our development and operations teams	S4
creation analysis and processing of error reports	S4
computer science	K05
agile approaches to software testing and development	S4
tools procedures and programming languages for test automation	S1
familiarize yourself with new technologies	S1
contribute innovations	S4
handling and understanding of web-based applications apis	S1
good eye for details user expectations and potential sources of error	S1
structured and result-oriented way of working	A1
willingness to learn	S1
joy of communication	S1
independent cooperation	S2
team skills	S1
social competence	K04
german	K02
english	K02
financial services	K10
financial services	K10
solving business problems	S1
innovation and engineering practices	S4
apply your depth of knowledge and expertise	S1
partner continuously with your many stakeholders	S1
stay focused on common goals	S1
bs/ba degree	K01
application	S4
data	K02
infrastructure architecture disciplines	S4
architecture and design	K04
programming languages	S1
industry-wide technology trends and best practices	S1
financial control	K04
budget management	S4
work in large collaborative teams	S1
achieve organizational goals	S1
building an innovative culture	S4
r	K09
java	K02
nosql	K02
r	K09
java	K02
nosql	K02
solving business problems	S1
innovation & engineering practices	S4
apply your depth of knowledge and expertise	S1
partner continuously with your many stakeholders	S1
focused on common goals	S1
energetic	A1
intelligent	A1
self-starter	A1
java	K02
rest/web services	S3
r	K09
pentaho	A1
oracle	A1
nosql	K02
agile	A1
application process management	K04
monitoring platforms	S4
streamlining integration	K04
issue tracking	K04
deployment	K04
change management	K04
communicate advanced technical design and solutions	S4
work collaboratively in teams	S1
develop meaningful relationships	S1
achieve common goals	S1
application data and infrastructure architecture & design disciplines	S1
analyse requirements	S4
interact directly with business users	S1
cloud micro-service and container deployment patterns	S4
testing	K04
ci	K02
behaviour driven development skills	S1
work in large collaborative teams	S1
achieve organizational goals	S1
building an innovative culture	S4
java	K02
r	K09
databases	K02
etl tools	S4
r	K09
python	K05
machine learning	K09
data tables	S1
Qpid/MQ/Kafka/RabbitMQ	S4
big	K02
financial performance calculations	K04
calculating benchmark blends	S4
entertainment	K10
gaming	K02
mobile game	A1
unity3d	K02
c#	A1
user-experience	S1
entertainment	K10
gaming	K02
mobile game	A1
unity3d	K02
c#	A1
user-experience	S1
flair for gameplay	A1
aesthetic know-how?	S1
work closely with other programmers designers and artists	S1
implementing and maintaining various platforms and systems	S4
unity	K01
mobile game development	S1
unity3d	K02
c#	A1
unity	K01
implement new game features	S1
making the designs look final and pretty	A1
self-driven	A1
open-minded	A1
not afraid to be critical	A1
collaborate with your colleagues	S1
find solutions	S1
implementing new gameplay features and user interfaces	S1
contributing to and maintaining existing game features	S4
participating in the development of new features and optimizing existing ones	S4
participating in the development of performant and rigid systems	S4
running tests on new code	S1
mobile games	K02
unity3d ( ios and/or android	S1
c#	A1
ux	K04
making user experiences at an interactive degree	S1
3d game programming	K04
math	K02
dynamic skills	A1
aesthetic know-how	S1
system and architectural thinking	S1
developing mobile games with a large amount of content delivery	S4
sense of f2p game design	S1
tdd ( test driven development	S1
objective c	S4
java	K02
computer software	K02
databases	K02
information technology	S1
java	K02
algorithm	K09
database	K02
multithreading	K01
concurrency	A1
computer software	K02
databases	K02
