design and refine every touchpoint of the customer journey	S3
design and refine every touchpoint of the customer journey	S3
tackling new problems and perspectives	S4
designing tools materials and stimulating content	S1
drive internal strategy and innovation	S4
CX	A1
content output	S1
impact technology can have on customers	S3
deliver a meaningful member experience	A1
researching and defining opportunities	S4
conduct interviews	S4
bring customer experience to life	A1
creating content	S4
deliver clear and attractive design outcomes	S1
defining our product roadmap	S4
delivering the right products and services	S3
driven by purpose	A1
cx design methodologies	S1
user journey planning	A1
qualitative research methods	A1
eye for beautiful design	K02
passion for innovative solutions	A1
take sketches and paper prototypes through to high quality design output	S4
communicator	S1
articulate clearly and effectively	A1
working both independently	A1
leading on collaborative design discovery	S1
Keynote	A1
Figma	A1
illustrator	K02
google workspace	A1
work with business leads	S1
structure draft and negotiate agreements	K09
advise clients on the various legal risks business strategies and other issues	S4
commercial transactions	S4
business operations	S4
contract drafting	S4
negotiation	A1
advisory	A1
provide strategic business and legal advice	S4
develop a comprehensive long-term approach	A1
manage and resolve legal issues	S4
commercial transaction support	S4
LLB	A1
qualified lawyer in eu member state	S4
media	K02
publishing	A1
internet companies	S1
drafting and negotiating technology and content acquisition licensing and distribution agreements	S4
current media and digital platform landscape	S4
thrive in a fast-paced hard working environment	A1
complete projects in a timely fashion	K09
teach children	K01
applied behaviour analysis	S4
psychology	K09
natural enthusiasm and energy to work with children	A1
interpersonal and communication skills	S1
listen	A1
understand	A1
educate	K01
advise	A1
present	A1
work as part of a professional team	A1
taking direction from managers	S4
giving and receiving feedback	S1
complement teachers’ delivery of the national curriculum	S4
develop the skills and strategies of other support staff	S1
work collaboratively with teaching staff	A1
assist teachers	S4
management/preparation of resources	S4
encourage pupils	S4
provide support	S1
support the inclusion of the pupil	S3
implement changes instructed by the bcba	S4
interpret and analyse data	S1
provide constructive feedback	S1
improve the functioning of the programme	S3
maintain consistency	A1
data analysis	S1
liaise with bcbas	S4
communicating data to a bcba	S1
ensuring that the data files are up to date	A1
identify the need for prepare and maintain teaching materials resources and data sheets	S1
monitor progress	A1
reviewing acquisition data behaviour frequency maintenance and generalisation	S2
identify short-term targets	A1
provide 1:1 intensive teaching sessions	S4
aba	S3
provide 1:1 support	S1
principles of aba	S3
enable inclusion	S4
support the child to engage with others participate and generalise skills	S1
use behaviour management strategies	S4
contribute to a purposeful learning environment	S1
encourage the pupil to interact and work cooperatively	S1
understand and implement school child protection procedures	S4
comply with legal responsibilities	A1
provide 1:1 support using the principles of aba	S4
aba	S3
enable inclusion	S4
support the child to engage with others participate and generalise skills	S1
provide personal care	S1
teach independence using the principles of aba	S4
aba	S3
record progress data	S1
working with children with autism	S3
aba	S3
support a child to access the national curriculum using aba principles	S3
communicate in a polite and professional way	A1
communicate effectively	A1
provide a customer-oriented service	S1
QCF	A1
overseeing and managing a small consistent highly trained and motivated staff team	S4
delivering care and support	S1
delivering childcare	S1
focused on obtaining the best outcomes	S3
demonstrate good leadership	A1
organise and support staff	S4
deliver the best possible care	A1
making sure the manager is aware of any and all incidents	S3
supervise and mentor staff	S4
organise work patterns	S1
facilitate training	S4
involved in liaising	A1
access appropriate services	S1
promote professional good practice	A1
quality control monitoring	S4
social care and well-being act 2014	S1
regulation and inspection of social care act 2016	S3
ensuring the smooth running of your shift	S3
ensuring that high standards are maintained	A1
support residential care workers	S1
building a strong positive work ethic	A1
ensuring the home is physically safe	A1
assisting with health and safety responsibilities	S3
completion of corresponding records	S1
providing a good quality home environment	S4
creating and developing links between the community and the home	S4
enable children to participate fully in the life of the community	S3
assist in the completion of impact assessments	S4
matching documentation	K09
oversight of the placement of children and young people	S4
ensuring the assessed needs of young people in the home can be met	S3
administering a system for monitoring progress	S4
preparing or overseeing each individual placement plan	S1
reviewing such plans	S1
ensure children/young people are supported to achieve	S3
contribute effectively to each child's individual placement plan review	S1
supporting children/young people	S3
review process	A1
ensuring that there is a comprehensive plan in place	S4
assist when requested in the completion of the rota	S3
ensuring there are always staff available	A1
promote an open and supportive atmosphere	S4
identifying the training and development of staff	S4
meet the objectives	S4
induction supervision and appraisal of staff	S4
supportive	A1
offer constructive feedback to staff	S1
ensure that you keep and maintain accurate records	S3
managing and monitoring paperwork and records	S3
advising on best practice	A1
ensuring that services are delivered	S3
statement of purpose	A1
managing and operating budgets	S4
sourcing appropriate services	S4
support the childcare practices	S1
provide regular budgetary updates	S4
ensure children and staff are aware of all the procedures	S3
qcf level 3	S3
l5 in leadership and management in health and social care	S4
registration and inspection social care act 2016	S1
service requirements	A1
working in a care setting	A1
managing budgets	S4
taking part in an inspection	S3
reasoning numeracy literacy	S1
technology skills	A1
work as part of a team	S1
working closely with colleagues and other agencies	S3
solve problems	S1
work within the principles of the children’s act and social services and wellbeing act	S3
children’s act and social services and wellbeing act	S3
child protection issues and procedures	S1
manpower	A1
planning/development/skills mix	S1
develop and encourage professional growth in others	S1
budgetary requirement and management	S4
lead effectively	A1
leadership abilities	A1
organisation and leadership skills	S4
lead motivate and influence others	S4
interpersonal skills	S1
approachable	A1
honest	A1
reliable	A1
accountability	A1
be responsible for the work undertaken	A1
driving licence	S1
RGN	A1
RMN	K09
RNLD	A1
nmc pin	S4
NMC	A1
sen	A1
supporting sen pupils	S1
learning difficulties	S1
autism	A1
SEMH	S4
work in a variety of ages and abilities	A1
learn about the curriculum and teaching techniques	S4
sen	A1
asc	S4
supporting sen – asc & semh	S4
SEMH	S4
proactive	A1
committed	A1
enthusiastic	A1
supporting sen	S1
build strong and productive relationships	S4
motivated	A1
ambitious	A1
creative	A1
driven	A1
put a personal touch on the menu	S3
brunch trends	S4
american comfort food	S4
lead a small team	S1
kitchen's day to day operations	S3
stock control	S4
compliance	S1
gp control	S4
managing supervising and training your kitchen team	S4
ensure high standards of hygiene are maintained	A1
come up with different exciting and unique brunch and evening dishes	S4
demonstrate leadership	A1
menu planning	S4
coshh	K09
hse	S4
EHO	A1
food hygiene qualification	K09
mechanical background	S1
assembly	A1
workshop	K05
use hand tools	S1
work from drawings and works instructions	S4
follow health & safety guidelines	S3
show willingness to help out	S1
work ethic	A1
food service	S4
striving for the best	A1
deliver first class customer service	S1
delivering a professional service	A1
ensuring all guests are given a warm welcome	S3
displaying excellent product knowledge	A1
help guests make the best choices	S3
ensuring all guests are treated in a professional manner	A1
taking orders promptly	S4
answering queries	A1
ensuring all areas in the restaurant and bar are clean and tidy	A1
support the kitchen with food service	S4
ensure guests receive their food in a timely manner	S3
work on the bar	S4
creating coffees and hot drinks	S4
providing a professional bar service to guests	S3
moving large tray of vegetables	A1
manual handling tasks	S4
food preparation	S4
retail sales	S4
customer service	S1
winning attitude	A1
food preparation	S4
bread and cookie baking	S4
ensure food storage and preparation areas are maintained	S3
health & safety and audit standards	S4
comply with food code of practice	A1
till operator	A1
monitoring stock levels	S4
checking in deliveries	S4
complete daily and weekly cleaning schedules	S3
follow security & safety procedures	S3
maintain a safe working environment	A1
maintain high personal presentation	S1
work as a team member	A1
deliver a high standard of service	A1
serve and add value to customer needs	S3
ensure hygiene standards are met	S4
meet and greet guests	S3
deliver exceptional customer service	A1
using flt to move stock throughout warehouse	S3
loading/ unloading trailers	S4
use of hand scanners & pc’s	S4
physically fit	K09
time keeping	A1
hard working attitude	A1
english	L1
work as a team & alone	A1
flt counterbalance licence	S4
administration	A1
diary management	S4
typing of correspondence	S1
attending meetings	S3
sales support	S1
processing invoices	S4
producing sales quotations	S4
team player	A1
flexible	A1
assist	S1
it	A1
word	A1
excel	A1
outlook	K06
powerpoint	A1
communicator	S1
build and develop strong relationships	S4
english	L1
valid passport	S1
full driving license	S4
travel	A1
working in a small team	A1
enjoy a variety of tasks	A1
aptitude to hygiene	K09
produce brilliant creative copy	A1
adept at taking a strategic direction and bringing ideas to life through the written word	S4
defining the brand voice and developing it through use of language and tone	S4
detail-oriented	S4
meticulous	A1
uphold quality standards of style and grammar	K09
produce high-quality edited messaging and content	S1
manage your time effectively	A1
prioritize and manage multiple projects	S4
working collaboratively	A1
communicator	S1
contribute to the culture	S1
oral and written communication skills	S1
interpersonal skills	S1
interact with people at all levels	S1
copywriting skills	S1
confident yet sensitive interviewing skills	S4
sub editing	A1
proofing	A1
attention to detail	A1
manage own workload	A1
work to deadlines	A1
writing	A1
brand strategy	A1
brand campaigns	S4
pitches	A1
proposals	A1
social	A1
internal communication	S1
office	A1
g-suite	S3
InDesign	A1
illustrator	K02
Keynote	A1
marketing	S1
creative writing	S4
communications	S1
hard worker	A1
customer service	S1
communicate respectfully with clients and the public	S1
multi trades work	S1
rail	A1
full uk driving licence	A1
flexible	A1
carpentry	A1
bricklaying	A1
plastering	K09
concrete repairs	K10
paving	S4
painting	A1
replacing doors and windows	S3
cscs card	K06
certification of skilled trades	S4
tfl certificate	K09
ce ( class 1 ) licence	S4
cpc	S4
digital tachograph	S1
Tipper	A1
walking floor	S4
wtd's ( working time directive	S1
health & safety conscious	A1
flexible	A1
cpc driver qualification card	S4
digi-card	S3
licence - category c+e	S4
Tachos	A1
cscs card	K06
ppe	S4
CSCS	S4
providing a world class patient service	S3
liaising with the manager	S4
drive performance in the store	S4
leading and inspiring fellow staff	A1
ensuring the clinic runs successfully and efficiently	A1
providing patients with the best optical products	S3
dealing with any enquiries effectively	A1
fulfilling management duties	S4
store operations and dispensing duties	S3
business and marketing acumen	S4
deliver the best customer service journey	S3
running of the store	S4
reporting to management	S1
striving to meet targets	A1
driving performance and sales	S4
motivating and leading staff	A1
deliver exceptional patient care	S1
smooth running of the clinic	S3
managing fellow staff members	A1
communicating any ideas or concerns	S1
ensure the best performance and development	S1
challenging the team	A1
deliver the best service	S1
excel targets	A1
dispensing duties	A1
recommending frames lenses and contact lenses	S3
reception and admin work	A1
diary upkeep	A1
patient appointments	K09
recruitment	K09
upholding to nhs guidelines	S4
nhs guidelines	S4
maintaining presentation and visual aesthetics of the store	S3
promoting the business	S4
optical	K09
accountable for nominated clients	S4
maximise profits	S1
develop the business	A1
ocean import	S4
commercial mindset	A1
demonstrate & generate enthusiasm	A1
'can-do' attitude	A1
identify problems	A1
respond in a timely fashion	K09
demonstrate personal drive	A1
communicate effectively	A1
active listening	A1
smart	A1
enthusiastic	A1
web development	S1
html	K02
css	S1
less	K01
SCSS	K01
PostCSS	S1
angular	K01
react	S1
js	S1
java	A1
c#	A1
client-side compatibility	S1
performance considerations	S4
debug issues in a full stack environment	A1
sql	A1
team player	A1
engage with colleagues	A1
communication skills	S1
independently conduct the experimental work	A1
design execution and analysis of phosphoproteomics experiments	S1
phd degree	K01
mass spectrometry-based quantitative proteomics	S3
phosphoproteomics	K09
molecular biology	K09
vector construction	S3
protein synthesis in e	K09
post-translational modifications	S1
b	A1
english	L1
communication and collaborations skills	S1
independence	A1
paper and project writing	K09
designing existing transport construction maintenance processes	S4
work in a dynamic and international team?	A1
developing and illustrating processes and concepts	S4
transport installation and maintenance of wind turbines	S3
develop construction concepts	S4
ensure that market requirements and best practice is included	A1
drive new product development	S4
ensure full value chain perspective in new products	S3
optimize construction	A1
cost reduction	S4
quality improvements	A1
collection of improvement suggestions and best practice	S1
plan and ensure development of global construction work processes	S4
ensure that requirements from the operational business are included in the wind turbine & tools designs	S3
create new concepts for turbine installation	S4
optimize existing processes	S4
testing verifying at site	S2
production	A1
supply chain	A1
production	A1
installation	S6
maintenance	A1
B.Sc	S4
production mechanical electrical marine engineering	S4
lean	A1
value stream mapping	S1
process mapping ( production or development	S1
develop processes or concepts for larger components	S4
risk assessment tools	S1
PFMEA	S4
process mapping	S4
communication	S1
presentation skills	S1
english	L1
cooperating with colleagues	S1
proactive mindset	A1
keep an overview in stressed situations	A1
outgoing	S4
project management skills	A1
handle complex pricing calculations?	S4
communicate quantitative analyzes	S1
influence the sales of large-scale projects?	S4
supporting the electricity sales team	S4
pricing calculations competitor analysis	A1
benchmarks	S1
prepare pricing calculations and price-/cost analysis	S4
present the calculations	S4
prepare business cases and benchmarks	S4
support the sales strategies	S4
build and maintain a database of submitted offers/kpis	S4
analytical proactive and structured workstyle	A1
high-quality mindset	A1
numerate	A1
communicative skills	S1
interact with your commercial and technical colleagues	S1
working independently	A1
build relationships across the organization	S3
innovative	A1
solution-oriented	S1
masters degree	K01
finance	S4
economics	S1
pricing and complex analysis	A1
microsoft powerpoint	A1
excel	A1
visual basic	K02
pivot	A1
capex/opex business cases	S4
english	L1
danish	L1
swedish	S4
norwegian	A1
pig production	A1
feeding	S1
moving	A1
castration	K09
insemination	S3
monitoring the animals health	S3
driving license	S4
desire to work with pigs	S1
work closely with developers designers and marketers	S4
develop beautiful campaigns	S4
create outstanding experiences	S4
maintain our frontend stack	S3
contribute with beautifully crafted layouts	S4
scalable and modulable code	A1
developing and integrating great frontend experiences	S1
collaborate with a team of designers copywriters and marketers	S4
craft and deliver exceptional landing pages and experiences	A1
deliver maximum impact	A1
creative solutions and ideas	S1
solve challenges	A1
improve our overall website & campaign performance	S4
build and maintain a design system and development process	S4
markup	A1
javascript	K02
organize and maintain markup javascript and css	S4
css	S1
developing quality well-performing and scalable code	A1
javascript	K02
html	K02
css/sass	S1
git	A1
angular	K01
react	S1
typescript	K01
restful apis	S2
responsive design media queries	K04
adobe creative suite	A1
sketch	S4
invision	S2
wordpress/php	K02
scrum/agile	A1
general management and development of the employees	S4
budget and resource allocation	S4
ensuring timely and efficient project execution	A1
drive the development of technology	S4
master or phd degree	K01
chemical/biochemical engineering	A1
bio(chemistry	S1
food science	A1
project leadership	A1
interfaces between external/internal customers	S1
commercial insight	S4
production	A1
drive technological advances	S4
increase expertise level in the department	A1
lead and motivate people	S4
communication skills	S1
people management	S4
implementation of successfactors	S4
compensation and performance management	S4
optimize and manage existing reward and benefits programmes and processes	S4
support the business priorities	S1
ensure local compliance	S1
develop global frameworks policies and programmes	S4
manage hq reward programmes	S4
perform benchmarking	S4
market analysis	A1
drive the annual salary review	S4
benchmarking work for salary range setting	S4
advise and train managers and hr business partners	S4
support strong anchoring of rewards policies and programmes	S4
rewards in a global context	S4
delivering a broad range of reward initiatives	S4
masters degree	K01
business administration	S4
hr	S4
finance	S4
economics	S1
excel	A1
powerpoint	A1
working with numbers and data	S4
strong focus on details	S1
building relationship with your stakeholders	S1
engaging with colleagues	S3
english	L1
registered surgeon	S2
patient-centred	S1
inclusive	A1
provide your patients with a safe and effective course of treatment	S3
see it systems as an aid in your work	S1
good humoured	A1
loyal	A1
dedicated	A1
flexible	A1
engage people in the streets	S3
conveying knowledge	S1
Extroverted	A1
energetic	A1
excited about meeting new people	A1
enjoy interacting with many different characters	A1
result oriented	A1
work constructively towards reaching goals	S1
good at acquiring new skills	A1
continuously working on your own development	A1
english	L1
valid visa to work in denmark	A1
read and understand addresses and house numbers	S3
team work	A1
cooperation	S1
walk on stairs	A1
ride a bike	S4
acceptable criminal record	A1
read the latin alphabet	S3
motivated	A1
good structure	A1
follow a route	A1
register when a shipment is delivered	S3
work professionally with high quality	A1
reliable	A1
responsible	A1
trustworthy	A1
responsible	A1
conscientious	A1
work in all kinds of weather at night	S1
good colleague	A1
lead and implement an aligned strategy	S4
drive the digital supply chain community	S4
developing and implementing a digital supply chain strategy	S4
sharing best practice	A1
developing new initiatives	A1
identify digital supply chain initiatives	S4
collaborate with internal customers	S1
agile program management	S4
digital solutions	S1
ensure a continued support knowledge sharing across segments	S4
digital supply chain	S4
energetic	A1
willing	A1
find compromises between multiple and sometimes conflicting interests	S1
strategic mindset	A1
big picture thinking	A1
deep dive	S4
customer obsession	K09
deliver results	A1
ownership	A1
implementation	S1
digital savvy	A1
data analytics	S1
process transformation	S4
iot ( industrial automation	A1
e-commerce	S4
startups	A1
agile	A1
communication presentation and facilitation skills	S1
well-structured	A1
independent working style	A1
willingness to travel	A1
curious	A1
enjoy learning	A1
develop new ideas	A1
create value	A1
manage risk from the sale and purchase of power	A1
work both independently and collaboratively	A1
deliver team objectives	K09
coordinate tender responses	S4
participate in contract negotiations	S4
build and maintain good working relationships	S4
acquiring knowledge	A1
developing understanding	S4
support team activities	S1
business	A1
economics	S1
maths	S1
desire to learn and develop	A1
proactive	A1
commercially astute	S4
problem-solving attitude	A1
team player	A1
thrive in an international environment	A1
communicator	S1
english	L1
self-starter	S1
enjoy a fast-paced work environment	A1
market analysis	A1
communication and analytical skills	S1
insights creation and commenting	S4
creation/ optimization of ppt	S4
revising stimulus material for research projects	S4
analysis of quantitative data	S1
working with multiple data sources and combining them into relevant insights	S1
dialogue and follow-up with research vendors	S1
contribute to insights communication	S1
marketing	S1
marketing	S1
business	A1
cand.merc	A1
cand.negot	S4
cand.oecon	S4
marketing	S1
market research	S4
thinking visually	A1
communicate your ideas and messages	S1
ambitious	A1
goal oriented	A1
show engagement	A1
demonstrate positive thinking	A1
can-do attitude	A1
see great challenges in being tasked with tactical as well as strategic marketing problems	S4
business understanding	S4
strategic	S4
analytical	A1
communicative	A1
dive into the numbers	S4
analyze	A1
turn numbers into actionable insights	S4
ms office tools	S1
excel	A1
PPT	S4
SPSS	S1
structured working style	A1
take on task responsibilities	S1
contribute with ideas and input	S1
english	L1
picking and packing	S3
picking and packing orders with a hand scanner	S3
receiving and registering goods	S3
controlling returned goods	S4
palletizing and shipments	A1
perfectionists	S4
manual work	A1
precise	A1
goal oriented	A1
team players	A1
helpful	A1
show initiative	A1
transport	S4
logistics	S4
people management and development?	S4
motivate and set the direction	S4
ensuring the pace of production	S4
develop your team	A1
professional leadership	A1
set the direction	S1
coach and develop your team	S1
ensure that production runs in accordance with gmp	S3
gmp	A1
enabling your team to deliver in a timely and flawless manner	A1
run or participate in systematic problem solving	S1
science	A1
pharmaceutical production	A1
managing people	S1
management	S4
gaining trust and respect	A1
structured	A1
keep the overall view	A1
thrive in a busy and constantly changing working day	A1
prioritize	S4
communication and collaboration skills	S1
gmp	A1
lean	A1
work in a structured and targeted manner	A1
never compromise on quality	A1
ensure continuous improvements	S4
motivated	A1
ambitious	A1
reliable	A1
maintaining cell lines	S3
perform molecular biology techniques	K09
pcr restriction	K09
cloning reactions	S1
dna/rna and protein purification procedures	S3
setting up routine imaging and cell sorting experiments	S3
sample preparation	S1
assist with the overall maintenance of the lab	S3
administration of several databases	S4
plasmids	K09
cell lines	S1
mouse colony	A1
antibodies	A1
purchasing	A1
stocking	S4
participate in the research projects	S1
responsible for training and providing technical assistance	A1
tissue culture techniques	S3
cell sorting	K09
working independently and organized	A1
self-motivated	A1
interpersonal and communication skills	S1
danish	L1
english	L1
basic molecular biology	K09
mouse research	A1
increase the value of it systems	S3
maintain and develop effective relationships?	S4
working in a dynamic environment?	A1
support your colleagues	S1
computer equipment	A1
telephony	S1
application support	S3
familiarise yourself with your colleagues' situation	S1
use your service skills to assist them as efficiently as possible	A1
prioritise incoming requests	A1
tick each task off the list	S4
providing first-line support	S3
communicating with and informing users	S1
resolving technical it issues	S4
providing application support	S4
receiving recording and referring cases to the appropriate team	S3
accurately executing specified procedures	A1
co-operation	S4
communicator	S1
it support	S4
microsoft's systems	S4
itsm tools	S1
application support	S3
work independently	A1
seeing your duties through to the end	S1
take a structured approach to work	A1
prioritising your tasks and identifying those that are the most important	A1
thrive in an outgoing role	A1
communicate concisely and accurately	A1
providing the best possible service	A1
demonstrating persistence	S1
patience	A1
attentiveness	S1
enjoy working in a dynamic environment	A1
english	L1
security clearance	S1
drive development of the software product roadmap	S4
find innovative solutions	A1
stays on top of current trends	S4
develop long term plans	S1
embrace work load enthusiastically	A1
comfortable with a fast paced quickly changing work environment	A1
technical and business skills	A1
articulate the vision in the way others will understand	S1
project management	S4
b2b market	S4
ux	A1
development	A1
define value proposition customer segments and customer channels	S4
lead the product development process	S4
correctly brief the other departments	S4
challenge outcomes	A1
english	L1
czech	S4
product / project management	S4
ux development process	S4
user testing	S4
understanding the results	S1
communication skills	S1
passion for a change	A1
establish rapport	A1
bond with a business partner	S4
think outside the box	A1
clearly and professionally present information	A1
generation and development of new and existing business opportunities	S4
credible	A1
lead generation	S1
appointment setting	A1
proposal development and presentation	A1
manage the international sales	S1
international sales	S1
business development process	S4
building new business relationships	S1
building on existing success	S4
reporting to the head of sales	S4
build new major business opportunities	S4
sales canvassing	S1
develop implement and manage sales and relationships	S1
negotiate and close business	A1
exceed targets	A1
being in regular telephonic and face to face contact with clients	S1
generate leads	S1
market and client-research	S4
break into medium to large organisations	A1
manage and be part of all processes of a typical sales cycle	S4
monitor competitor activity and market dynamics	S2
recognise and recommend improvements to existing processes	S4
improve revenue performance	S4
inspiring	A1
persuasive	A1
convincing	S4
sales canvassing	S1
cold calling	S4
booking meetings on the phone	S3
outgoing	S4
javascript	K02
reactjs	S1
java	A1
javascript	K02
reactjs	S1
java	A1
solving business problems	A1
innovation and engineering practices	A1
apply your depth of knowledge and expertise	S1
software development lifecycle	S4
partner continuously with your many stakeholders	S1
stay focused on common goals	A1
motivated	A1
deliver of a next-generation analytics products	S4
bs/ba degree	K01
application data and infrastructure architecture disciplines	S3
architecture	K02
design	K02
developmental toolsets	S1
industry-wide technology strategies and best practices	A1
work in large collaborative teams	S4
achieve organizational goals	S4
building an innovative culture	A1
java	A1
javascript	K02
business analysis	A1
development	A1
maintenance	A1
software improvement	A1
html5	K02
javascript	K02
developing multithreaded scalable concurrent applications	S3
node js ( server side and tooling	S1
react	S1
java	A1
spring	A1
java-ee	A1
java	A1
spring	A1
java-ee	A1
solving business problems	A1
innovation and engineering practices	A1
apply your depth of knowledge and expertise	S1
software development lifecycle	S4
partner continuously with your many stakeholders	S1
stay focused on common goals	A1
bs/ba degree	K01
java	A1
spring boot	S1
nosql	A1
message	A1
cloud	S3
ci/cd	S4
application data and infrastructure architecture disciplines	S3
architecture	K02
design	K02
developmental toolsets	S1
industry-wide technology trends and best practices	S1
work in large collaborative teams	S4
achieve organizational goals	S4
building an innovative culture	A1
modern programming languages	S4
business analysis	A1
development	A1
maintenance	A1
software improvement	A1
financial technology	A1
saas	S4
wealthtech	A1
azure	A1
.net	S1
asp.net-web-api	S1
powershell	A1
json.net	S4
financial technology	A1
saas	S4
wealthtech	A1
azure	A1
.net	S1
asp.net-web-api	S1
powershell	A1
json.net	S4
open for continuous change	S4
automation	A1
azure paas	S4
microservices	S4
.net	S1
powershell	A1
ms sql	A1
ci	K09
azure paas	S4
enhance and maintain ci infrastructure pipelines and azure paas environments	S4
ensure on-going health and stability of pipelines across multiple environments	S3
azure	A1
administrate and manage azure resources	S4
subscriptions	S4
resource groups	S4
devops	K01
GitHub	A1
support developers	S4
troubleshooting deployed applications	S3
identify app issues vs configuration/environment issues	S4
enhance quality through pipelines	S4
usage of static analysis tools	A1
SonarQube	A1
.net analyzers	S4
infer#	A1
creating and maintaining build and deployment pipelines for web applications and services	S4
azure appservice	S4
iis	S1
sql dbs	S2
azure appservice	S4
troubleshoot azure appservice hosted websites and services	S4
identify app issues vs configuration/environment issues	S4
.net	S1
automation	A1
powershell	A1
azure cli	S4
json	A1
yaml	A1
based templates	S1
AppServices	S4
redis	A1
ServiceBus	A1
api management	S4
CosmosDB	S4
KeyVault	S4
azure sql	S4
sql scripts	S4
azure devops ( cloud and server	S4
docker containers	S4
K8s	K09
english	L1
financial services	A1
java	A1
reactjs	S1
web-services	S1
financial services	A1
java	A1
reactjs	S1
web-services	S1
solving business problems	A1
innovation & engineering practices	A1
apply your depth of knowledge and expertise	S1
software development lifecycle	S4
partner continuously with your many stakeholders	S1
stay focused on common goals	A1
bs/ba degree	K01
application data and infrastructure architecture	K09
architecture	K02
design	K02
software systems	A1
developmental toolsets	S1
industry wide technology strategies and best practices	A1
work in a co-located team	A1
achieve organizational goals	S4
building an innovative culture	A1
software skills	A1
business analysis	A1
development	A1
maintenance	A1
software improvement	A1
deliver high quality products	A1
java/j2ee	S4
python	A1
go	A1
react	S1
cloud technologies	A1
AWS	S4
containers	S4
Kubernetes	K09
devops for platforms	S4
automated testing	K09
resource management	S4
artificial intelligence	A1
computer graphics	A1
software development	K01
python	A1
artificial intelligence	A1
computer graphics	A1
software development	K01
python	A1
build highly efficient accurate and scalable computer vision and machine learning services	S4
computer science	A1
solve technical challenges independently	A1
python	A1
english	L1
good communicator	A1
enjoy working in a team	A1
postgresql	A1
Django	A1
PostGIS	K09
opencv	S1
NumPy	A1
shapely	A1
pyhon multithreading and multiprocessing	S1
aws/azure	S4
computer vision	S4
machine learning	S1
e-commerce	S4
open-source	A1
ruby-on-rails	A1
sql	A1
heroku	A1
e-commerce	S4
open-source	A1
ruby-on-rails	A1
sql	A1
heroku	A1
gather technical requirements	A1
architect solutions	A1
estimate timelines	A1
deliver and further develop applications	S4
communicate	S1
investigate	A1
celebrate	A1
reward	S1
promote	S4
TDD	A1
agile delivery	A1
teamwork	A1
automated testing	K09
code reviews	A1
pair programming	A1
qa	S3
pm support	S4
staying in touch	A1
ruby on rails	A1
TDD	A1
deploy apps	S4
Heroku	A1
AWS	S4
sql	A1
english	L1
agile/scrum	A1
working with 3rd party api’s	S3
performed code reviews	S1
Docker	A1
spree commerce	A1
leading a team	A1
contributions to open source projects	S4
e-commerce	S4
ElasticSearch	A1
Kubernetes	K09
financial services	A1
reactjs	S1
cloud	S3
python	A1
financial services	A1
reactjs	S1
cloud	S3
python	A1
deliver initiatives	A1
modernizing and transforming the platform	S3
work on a mix of front-end back-end and cloud technologies	S4
running with a full stack development	A1
java	A1
python	A1
react js	S1
Redux	A1
public and private cloud offerings	S4
data warehousing/etl	A1
fixed income instruments	S3
reference data	S1
django	A1
postgresql	A1
redis	A1
django	A1
postgresql	A1
redis	A1
build software	S4
help our customers	S1
build and expand our predictive analytics platform	S4
work with a tightly knit team	S1
enterprise resource planning ( erp	A1
point-of-sales ( pos	S1
identify problems	A1
run experiments	S4
deploy promising solutions to production	S4
develop interfaces to erp and pos software providers	S4
etl	A1
work on etl pipelines	S1
integrate our customers data bases	S1
work closely together with our machine learning	S1
effective communication	A1
documentation	K09
writing software with emphasis on quality testability and automation	K09
backend development	S4
python	A1
linux administration	S4
Docker	A1
ansible	K09
git	A1
Pandas	A1
Celery	A1
django channels	S4
django rest framework	S4
redis	A1
Nginx	A1
gitlab ci	S1
postgresql	A1
english on level c1	S4
honest	A1
trustworthy	A1
communicates openly	S1
Cybersecurity	S4
data & analytics	S1
digital marketing	S1
powerbi	A1
dax	A1
cloud	S3
data-modeling	S1
azure-analysis-services	S4
Cybersecurity	S4
data & analytics	S1
digital marketing	S1
powerbi	A1
dax	A1
cloud	S3
data-modeling	S1
azure-analysis-services	S4
building front-end layer	S4
design and build front-end / bi layer	S4
power bi reports	S1
dax queries	S4
azure analysis services models	S4
troubleshoot issues	A1
recommend optimizations	K09
tune solution / reports for better performance	S4
scrum meetings	A1
sprint planning	A1
code reviews	A1
power bi	A1
DAX	A1
data modeling	S1
cloud	S3
CICD	S4
devops	K01
agile	A1
english	L1
bachelor's degree	K01
azure analysis services	S4
agile software development	A1
financial technology	A1
agile	A1
architecture	K02
agile software development	A1
financial technology	A1
agile	A1
architecture	K02
making the right decisions	S1
definition & communication of “fit for purpose”	S1
describing a solution architecture	A1
aligning the teams around the technical orientation	S3
connects with the teams	S1
evaluate the different technical alternatives	S3
continuous exploration and innovation	A1
delivery to business ( d2b	S1
service to deliver ( s2d	S1
work in delivery to business ( d2b ) or service to deliver ( s2d ) context	S1
creating business enabler art epics	S4
software/system design and architecture	A1
design	K02
modelling	S1
documentation	K09
solution architecture	A1
programming languages	S4
analyzing strategic objectives	S4
defining specific goals	S4
it or engineering bachelor / master degree	A1
scaled agile ( safe	A1
analytical and problem-solving skills	A1
networking	S1
communication	S1
persuasion	K09
ability to persuade others	S1
build and maintain positive and trustworthy relationships	S1
share knowledge	S1
engage in discussions and group decision-making	S1
presentation skills	S1
assertive	A1
pro-active	A1
personal efficiency	A1
financial technology	A1
c#	A1
f#	A1
typescript	K01
financial technology	A1
c#	A1
f#	A1
typescript	K01
modern workflows and tooling	A1
maintain quality	A1
work with aws infrastructure	S1
producing cloud native software	S4
continuous integration	S4
automated testing	K09
domain modelling	S4
ubiquitous language	A1
logging	A1
serverless containerisation	A1
dev/prod environment parity	S1
experimentation	S4
c#	A1
f#	A1
typescript	K01
serverless framework	A1
functional programming	A1
Cypress	A1
Jest	A1
Nunit	L1
SpecFlow	K10
Expecto	A1
FsCheck	S4
canopy	A1
functions as a service	S3
hosting	A1
messaging	S1
relational and non-relational databases	S1
Loggly	A1
c#	A1
f#	A1
typescript	K01
problem solver	A1
curious about new technology	S4
functional programming	A1
12-factor app approach	S3
build cloud	S4
takes ownership	A1
learn as much as possible	A1
good listener	A1
able to explain concepts	A1
committed to improving yourself	A1
demonstrate interest in technologies that are beyond the scope of your daily workflow	S3
lazy	A1
don't like boring repetitive tasks	A1
outsource your labour to the compiler	S3
applying yourself to learning	S1
pragmatist	A1
qa	S3
testing	K09
cypress	A1
mocha.js	S4
chai	S4
qa	S3
testing	K09
cypress	A1
mocha.js	S4
chai	S4
introduce and implement the newest standards and testing solutions/automation	S4
product creation	S4
build and provide access to test environments and new features	S2
responsible for a successful product launch	A1
bring expert knowledge	A1
define testing standards and strategies	S4
create detailed comprehensive and well-structured test plans and test cases	S4
design develop and execute automatic tests	S4
conduct exploratory/manual tests	S4
identify record document thoroughly and track bugs	S2
work closely with the product team	A1
make new features testable	A1
improve tickets	S1
update product information	S2
facilitate test environments access	S4
quality assurance	A1
software qa methodologies tools and processes	S1
automated testing tools	S4
Cypress	A1
pytest	A1
truffle	A1
solidity	A1
coding/scripting	S4
devops	K01
build test environments	S4
CircleCI	S4
Docker	A1
work in an agile & energetic startup environment	A1
english	L1
collaboration tools	S1
computer software	S1
open-source	A1
testing	K09
qa	S3
automation	A1
software-quality	A1
automated-tests	S4
collaboration tools	S1
computer software	S1
open-source	A1
testing	K09
qa	S3
automation	A1
software-quality	A1
automated-tests	S4
ensuring high quality for customer-specific software projects	S3
analysis and risk assessment	S1
creation maintenance execution and documentation of ( automated ) tests	S4
collaboration in project teams	S1
communication with technical customer departments	S1
active support of our development and operations teams	S4
creation analysis and processing of error reports	S4
computer science	A1
agile approaches to software testing and development	S4
tools procedures and programming languages for test automation	S4
familiarize yourself with new technologies	S1
contribute innovations	S4
handling and understanding of web-based applications apis	S3
good eye for details user expectations and potential sources of error	S3
structured and result-oriented way of working	A1
willingness to learn	A1
joy of communication	S1
independent cooperation	A1
team skills	S1
social competence	S1
german	A1
english	L1
financial services	A1
financial services	A1
solving business problems	A1
innovation and engineering practices	A1
apply your depth of knowledge and expertise	S1
partner continuously with your many stakeholders	S1
stay focused on common goals	A1
bs/ba degree	K01
application	S2
data	K06
infrastructure architecture disciplines	S4
architecture and design	K02
programming languages	S4
industry-wide technology trends and best practices	S1
financial control	S4
budget management	S4
work in large collaborative teams	S4
achieve organizational goals	S4
building an innovative culture	A1
r	A1
java	A1
nosql	A1
r	A1
java	A1
nosql	A1
solving business problems	A1
innovation & engineering practices	A1
apply your depth of knowledge and expertise	S1
partner continuously with your many stakeholders	S1
focused on common goals	S1
energetic	A1
intelligent	A1
self-starter	S1
java	A1
rest/web services	S4
r	A1
pentaho	A1
oracle	A1
nosql	A1
agile	A1
application process management	S4
monitoring platforms	S4
streamlining integration	K09
issue tracking	S4
deployment	A1
change management	S4
communicate advanced technical design and solutions	S1
work collaboratively in teams	A1
develop meaningful relationships	S1
achieve common goals	A1
application data and infrastructure architecture & design disciplines	S4
analyse requirements	A1
interact directly with business users	S1
cloud micro-service and container deployment patterns	S3
testing	K09
ci	K09
behaviour driven development skills	S1
work in large collaborative teams	S4
achieve organizational goals	S4
building an innovative culture	A1
java	A1
r	A1
databases	S1
etl tools	A1
r	A1
python	A1
machine learning	S1
data tables	S1
Qpid/MQ/Kafka/RabbitMQ	S4
big	A1
financial performance calculations	S4
calculating benchmark blends	S4
entertainment	S1
gaming	A1
mobile game	A1
unity3d	S3
c#	A1
user-experience	S1
entertainment	S1
gaming	A1
mobile game	A1
unity3d	S3
c#	A1
user-experience	S1
flair for gameplay	A1
aesthetic know-how?	S1
work closely with other programmers designers and artists	S3
implementing and maintaining various platforms and systems	S4
unity	S4
mobile game development	A1
unity3d	S3
c#	A1
unity	S4
implement new game features	S1
making the designs look final and pretty	A1
self-driven	A1
open-minded	A1
not afraid to be critical	A1
collaborate with your colleagues	S1
find solutions	S1
implementing new gameplay features and user interfaces	S4
contributing to and maintaining existing game features	S4
participating in the development of new features and optimizing existing ones	S4
participating in the development of performant and rigid systems	S4
running tests on new code	S4
mobile games	S4
unity3d ( ios and/or android	S3
c#	A1
ux	A1
making user experiences at an interactive degree	S1
3d game programming	K02
math	A1
dynamic skills	A1
aesthetic know-how	A1
system and architectural thinking	A1
developing mobile games with a large amount of content delivery	S4
sense of f2p game design	S1
tdd ( test driven development	S4
objective c	S4
java	A1
computer software	S1
databases	S1
information technology	S1
java	A1
algorithm	A1
database	L1
multithreading	K09
concurrency	A1
computer software	S1
databases	S1
